A	ఆ
ADEstAru	ఆడేస్తారు
ADapaDuculU	ఆడపడుచులూ
ADapaDucunu	ఆడపడుచును
ADapillalaitE	ఆడపిల్లలైతే
ADapillalaku	ఆడపిల్లలకు
ADapillalu	ఆడపిల్లలు
ADavAriki	ఆడవారికి
ADukOvaDAniki	ఆడుకోవడానికి
ADukuMTAru	ఆడుకుంటారు
ADutunnAM	ఆడుతున్నాం
ALlagaDDa	ఆళ్లగడ్డ
ALlagaDDalOnE	ఆళ్లగడ్డలోనే
ALvAr	ఆళ్వార్
ALvAru	ఆళ్వారు
ALvArutIrthaMgA	ఆళ్వారుతీర్థంగా
AMDrAlajI	ఆండ్రాలజీ
AMTI	ఆంటీ
AMdOLana	ఆందోళన
AMdOLanaku	ఆందోళనకు
AMdhrIkariMcEMduku	ఆంధ్రీకరించేందుకు
AMdhra	ఆంధ్ర
AMdhrabhAshapai	ఆంధ్రభాషపై
AMdhramahAvishNuvuni	ఆంధ్రమహావిష్ణువుని
AMdhrapradES	ఆంధ్రప్రదేశ్
AMjanEya	ఆంజనేయ
AMjanEyasvAmi	ఆంజనేయస్వామి
AMjanEyasvAmiki	ఆంజనేయస్వామికి
ASAbhaMgaM	ఆశాభంగం
ASIrvadistuMTADu	ఆశీర్వదిస్తుంటాడు
ASIrvadistunnaTTu	ఆశీర్వదిస్తున్నట్టు
AScaryAniki	ఆశ్చర్యానికి
AScaryakaraMgA	ఆశ్చర్యకరంగా
AScaryamEmuMdi	ఆశ్చర్యమేముంది
ASiMcAli	ఆశించాలి
ASiMcaTamannadi	ఆశించటమన్నది
ASistADani	ఆశిస్తాడని
ASrayiMcAlanna	ఆశ్రయించాలన్న
ASrayiMcE	ఆశ్రయించే
ASrita	ఆశ్రిత
ATO	ఆటో
ATOlU	ఆటోలూ
ATOllOnU	ఆటోల్లోనూ
ATOlu	ఆటోలు
ATa	ఆట
ATaMkAlU	ఆటంకాలూ
ATaMkaM	ఆటంకం
AbagA	ఆబగా
AcOTanE	ఆచోటనే
AcariMci	ఆచరించి
AdESiMcADaTa	ఆదేశించాడట
AdarAbAdaragA	ఆదరాబాదరగా
AdaristAranI	ఆదరిస్తారనీ
AdhArAlanu	ఆధారాలను
AdhArAlni	ఆధారాల్ని
AdhArAlu	ఆధారాలు
AdhAraMgA	ఆధారంగా
AdhAramayyAyi	ఆధారమయ్యాయి
AdhArapaDakuMDA	ఆధారపడకుండా
AdhArapaDi	ఆధారపడి
Adhunika	ఆధునిక
AdhunikatalaMTU	ఆధునికతలంటూ
AdhvaryaMlO	ఆధ్వర్యంలో
AdhvaryaMlOnU	ఆధ్వర్యంలోనూ
AdhyAtmika	ఆధ్యాత్మిక
Adi	ఆది
AdiSaMkarulu	ఆదిశంకరులు
AdityuDi	ఆదిత్యుడి
AdyaMtaM	ఆద్యంతం
AgAkE	ఆగాకే
AgalEdu	ఆగలేదు
AgnEya	ఆగ్నేయ
AgnEyamUla	ఆగ్నేయమూల
AhA	ఆహా
AhAraM	ఆహారం
AhlAdaM	ఆహ్లాదం
AhlAdabharitaM	ఆహ్లాదభరితం
AhlAdakaramaina	ఆహ్లాదకరమైన
AhvAniMcADu	ఆహ్వానించాడు
AhvAniMcEMduku	ఆహ్వానించేందుకు
AhvAnistAnani	ఆహ్వానిస్తానని
AjJApistADu	ఆజ్ఞాపిస్తాడు
AkASa	ఆకాశ
AkASagaMga	ఆకాశగంగ
AkASarAju	ఆకాశరాజు
AkAraMlO	ఆకారంలో
AkRti	ఆకృతి
Akali	ఆకలి
AkarshaNIyaMgA	ఆకర్షణీయంగా
AkarshaNa	ఆకర్షణ
AkarshiMcalEmOnanna	ఆకర్షించలేమోనన్న
AkramistuMdi	ఆక్రమిస్తుంది
AksalET	ఆక్సలేట్
Aksijan	ఆక్సిజన్
AkulamainaMduku	ఆకులమైనందుకు
AkupUja	ఆకుపూజ
AlOcanA	ఆలోచనా
AlOcana	ఆలోచన
AlOcanalaku	ఆలోచనలకు
AlOcanalani	ఆలోచనలని
AlOcanalanu	ఆలోచనలను
AlOcanalu	ఆలోచనలు
AlOcanaluMTE	ఆలోచనలుంటే
AlOciMcaTaM	ఆలోచించటం
AlOciMcalEni	ఆలోచించలేని
AlOcistUnE	ఆలోచిస్తూనే
AlOcistuMDagAnE	ఆలోచిస్తుండగానే
AlOcistuMTAru	ఆలోచిస్తుంటారు
AlOcistunnAru	ఆలోచిస్తున్నారు
AlayAlanu	ఆలయాలను
AlayAllOnU	ఆలయాల్లోనూ
AlayAlu	ఆలయాలు
AlayAlunnAyi	ఆలయాలున్నాయి
AlayAniki	ఆలయానికి
AlayAnni	ఆలయాన్ని
Alaya	ఆలయ
AlayaM	ఆలయం
AlayaMlO	ఆలయంలో
AlayaMlOki	ఆలయంలోకి
AlayaMlOni	ఆలయంలోని
AlayaMtO	ఆలయంతో
AlayaMtOpATu	ఆలయంతోపాటు
AlumUru	ఆలుమూరు
AmOdaM	ఆమోదం
AmOdiMciMdi	ఆమోదించింది
Amadhya	ఆమధ్య
Ame	ఆమె
Amenu	ఆమెను
AmuktamAlyada	ఆముక్తమాల్యద
An	ఆన్
AnaMdAnni	ఆనందాన్ని
AnaMdAnniccE	ఆనందాన్నిచ్చే
AnaMda	ఆనంద
AnaMdaM	ఆనందం
AnaMdaMgA	ఆనందంగా
AnaMdabharitaMgA	ఆనందభరితంగా
AnaMdadAyakamaina	ఆనందదాయకమైన
AnaMdakaramaina	ఆనందకరమైన
AnaMdamE	ఆనందమే
AnaMdanilayuDaina	ఆనందనిలయుడైన
AnaMdiMcAlsinaMtagA	ఆనందించాల్సినంతగా
AnavAyitI	ఆనవాయితీ
AniMcAli	ఆనించాలి
Anukuni	ఆనుకుని
ApAdiMci	ఆపాదించి
Apai	ఆపై
ApakuMDA	ఆపకుండా
AparEshan	ఆపరేషన్
Aph	ఆఫ్
AphIsulO	ఆఫీసులో
AphIsulOnE	ఆఫీసులోనే
ApukOkUDadu	ఆపుకోకూడదు
ApukOvaTaM	ఆపుకోవటం
ApyAyata	ఆప్యాయత
ApyAyataluMTAyanna	ఆప్యాయతలుంటాయన్న
Ar	ఆర్
ArATaM	ఆరాటం
ArAdhakulu	ఆరాధకులు
ArAdhana	ఆరాధన
ArAdhiMci	ఆరాధించి
ArAdhistunnavArU	ఆరాధిస్తున్నవారూ
ArOgyAlu	ఆరోగ్యాలు
ArOgyAnikI	ఆరోగ్యానికీ
ArOgyAniki	ఆరోగ్యానికి
ArOgyAnni	ఆరోగ్యాన్ని
ArOgya	ఆరోగ్య
ArOgyaM	ఆరోగ్యం
ArOgyaMgA	ఆరోగ్యంగా
ArOgyaMpai	ఆరోగ్యంపై
ArOgyaMtO	ఆరోగ్యంతో
ArOgyakaraMgA	ఆరోగ్యకరంగా
ArOgyakaramaina	ఆరోగ్యకరమైన
ArOgyamannadi	ఆరోగ్యమన్నది
ArOju	ఆరోజు
ArOjullO	ఆరోజుల్లో
ArTIsI	ఆర్టీసీ
AraMbhaMlO	ఆరంభంలో
AraMbhamai	ఆరంభమై
AraMbhamaiMdi	ఆరంభమైంది
AraMbhamavutuMdi	ఆరంభమవుతుంది
AraMbhiMcAli	ఆరంభించాలి
AraMbhiMcaTaMtO	ఆరంభించటంతో
AraMbhiMci	ఆరంభించి
ArdrOtsavAnni	ఆర్ద్రోత్సవాన్ని
Arjita	ఆర్జిత
ArjitasEvalu	ఆర్జితసేవలు
Arthika	ఆర్థిక
ArthikaMgA	ఆర్థికంగా
ArtigA	ఆర్తిగా
Aru	ఆరు
ArudrA	ఆరుద్రా
Arudra	ఆరుద్ర
ArukilOmITarla	ఆరుకిలోమీటర్ల
Arunelala	ఆరునెలల
AruvaMdala	ఆరువందల
Asakti	ఆసక్తి
Asaktikaramaina	ఆసక్తికరమైన
Asaktini	ఆసక్తిని
Asaktulu	ఆసక్తులు
AsanAlE	ఆసనాలే
AsanAla	ఆసనాల
AsanAlanu	ఆసనాలను
AsanAlu	ఆసనాలు
Asana	ఆసన
AshADhamAsaM	ఆషాఢమాసం
AskAraM	ఆస్కారం
AskAramuMTuMdani	ఆస్కారముంటుందని
AsthAnakavi	ఆస్థానకవి
AstulannI	ఆస్తులన్నీ
Astulu	ఆస్తులు
Asupatri	ఆసుపత్రి
Asupatriki	ఆసుపత్రికి
AsupatrilOnE	ఆసుపత్రిలోనే
AsvAdiMcE	ఆస్వాదించే
AsvAdiMcElA	ఆస్వాదించేలా
AsvAdiMcalEmani	ఆస్వాదించలేమని
AsvAdiMcoccu	ఆస్వాదించొచ్చు
AtarvAta	ఆతర్వాత
AtmAhuti	ఆత్మాహుతి
Atma	ఆత్మ
AtmanyUnatatO	ఆత్మన్యూనతతో
AtmaviSvAsaM	ఆత్మవిశ్వాసం
AvAlU	ఆవాలూ
AvaSyakaMgA	ఆవశ్యకంగా
AvaraNalO	ఆవరణలో
AvariMciMdi	ఆవరించింది
AvariMcina	ఆవరించిన
AvaristuMTuMdi	ఆవరిస్తుంటుంది
AviDE	ఆవిడే
AviraiMdi	ఆవిరైంది
AvirbhAviMcAyanI	ఆవిర్భావించాయనీ
AvirbhaviMcADani	ఆవిర్భవించాడని
AvirbhaviMcina	ఆవిర్భవించిన
Aviri	ఆవిరి
AvishkArAniki	ఆవిష్కారానికి
AvishkAraM	ఆవిష్కారం
AvishkaristOMdi	ఆవిష్కరిస్తోంది
AyA	ఆయా
Ayana	ఆయన
AyuHpramANaM	ఆయుఃప్రమాణం
CArTeD	ఛార్టెడ్
CAtI	ఛాతీ
CAtIki	ఛాతీకి
CAtIlO	ఛాతీలో
CEdiMcaTAniki	ఛేదించటానికి
CEdiMcukuni	ఛేదించుకుని
CI	ఛీ
CICI	ఛీఛీ
CIcCI	ఛీచ్ఛీ
DA	డా
DAT	డాట్
DAkTar	డాక్టర్
DAkTarlu	డాక్టర్లు
DAlarla	డాలర్ల
DAplar	డాప్లర్
DOlOtsavAnni	డోలోత్సవాన్ని
Dab	డబ్
Dabbu	డబ్బు
DabbuMDaTaM	డబ్బుండటం
DairekTarlu	డైరెక్టర్లు
Dappu	డప్పు
DayAphraM	డయాఫ్రం
DayAphramATik	డయాఫ్రమాటిక్
Debbhai	డెబ్భై
DhamarukAdi	ఢమరుకాది
DhuMDi	ఢుండి
DigrI	డిగ్రీ
DilDUlu	డిల్డూలు
DipAjiT	డిపాజిట్
DipAjiTlalAgA	డిపాజిట్లలాగా
Dipreshan	డిప్రెషన్
DipyUTI	డిప్యూటీ
DiseMbarulO	డిసెంబరులో
Divais	డివైస్
E	ఏ
EDAdi	ఏడాది
EDAdipATu	ఏడాదిపాటు
EDAditO	ఏడాదితో
EDu	ఏడు
EDukoMDalavADani	ఏడుకొండలవాడని
EDustU	ఏడుస్తూ
ELla	ఏళ్ల
ELlaku	ఏళ్లకు
ELlugA	ఏళ్లుగా
EM	ఏం
EMTaMTE	ఏంటంటే
ETA	ఏటా
ETIem	ఏటీఎమ్
EdO	ఏదో
EdainA	ఏదైనా
Edani	ఏదని
Edi	ఏది
EdigEkoddI	ఏదిగేకొద్దీ
Een	ఏఎన్
EkAMtaM	ఏకాంతం
EkAdaSi	ఏకాదశి
EkAdaSinADu	ఏకాదశినాడు
EkAgratA	ఏకాగ్రతా
EkAgratatO	ఏకాగ్రతతో
EkakAlaMlO	ఏకకాలంలో
Elina	ఏలిన
ElubaDilOnE	ఏలుబడిలోనే
EmAtraM	ఏమాత్రం
EmI	ఏమీ
EmiTI	ఏమిటీ
EmiTO	ఏమిటో
EmiTi	ఏమిటి
EmistAvani	ఏమిస్తావని
EnugulU	ఏనుగులూ
EpI	ఏపీ
Epril	ఏప్రిల్
ErObik	ఏరోబిక్
ErpATaiMdi	ఏర్పాటైంది
ErpATlu	ఏర్పాట్లు
ErpATu	ఏర్పాటు
ErpATucESAru	ఏర్పాటుచేశారు
ErpATucEyaMDi	ఏర్పాటుచేయండి
ErpaDE	ఏర్పడే
ErpaDaTAniki	ఏర్పడటానికి
ErpaDi	ఏర్పడి
ErpaDiMdaMTE	ఏర్పడిందంటే
ErpaDiMdi	ఏర్పడింది
ErpaDutuMdi	ఏర్పడుతుంది
ErparacukOvaTaM	ఏర్పరచుకోవటం
EvEvO	ఏవేవో
EvainA	ఏవైనా
Evi	ఏవి
EyE	ఏయే
I	ఈ
ISvaruDu	ఈశ్వరుడు
ISvaruni	ఈశ్వరుని
Ij	ఈజ్
IkshEtra	ఈక్షేత్ర
IsaDiMcEstunnAM	ఈసడించేస్తున్నాం
IsaMstha	ఈసంస్థ
O	ఓ
ONItO	ఓణీతో
Oli	ఓలి
OrOju	ఓరోజు
OsAri	ఓసారి
Ovar	ఓవర్
SAMta	శాంత
SAMtaparacEMduku	శాంతపరచేందుకు
SAMtistADu	శాంతిస్తాడు
SAkha	శాఖ
SAkhala	శాఖల
SAkhalu	శాఖలు
SArIraka	శారీరక
SArIrakaMgA	శారీరకంగా
SAsanAla	శాసనాల
SAsanAlu	శాసనాలు
SAsanaM	శాసనం
SAstrIya	శాస్త్రీయ
SAstrIyaMgA	శాస్త్రీయంగా
SAstrIyamaina	శాస్త్రీయమైన
SAstra	శాస్త్ర
SAstraMgA	శాస్త్రంగా
SAstraMlAgA	శాస్త్రంలాగా
SAtaM	శాతం
SRMgArAniki	శృంగారానికి
SRMgArAnni	శృంగారాన్ని
SRMgArAnubhavAnnI	శృంగారానుభవాన్నీ
SRMgAra	శృంగార
SRMgAraM	శృంగారం
SRMgAraMtO	శృంగారంతో
SRMgAramaMTE	శృంగారమంటే
SRMgAramaMTEnE	శృంగారమంటేనే
SRMgAramanEdi	శృంగారమనేది
SRMgAramannadi	శృంగారమన్నది
SaMkaramaThaM	శంకరమఠం
SaMshAbAd	శంషాబాద్
SaThagOpa	శఠగోప
SabdaM	శబ్దం
SailaM	శైలం
SaililO	శైలిలో
Saiva	శైవ
SaivakshEtraM	శైవక్షేత్రం
SaivulakU	శైవులకూ
Saivulu	శైవులు
SakalAlu	శకలాలు
SaktaMtA	శక్తంతా
Saktini	శక్తిని
SaktipIThAllOnU	శక్తిపీఠాల్లోనూ
SaktipIThAlni	శక్తిపీఠాల్ని
SanivAra	శనివార
SanivAraM	శనివారం
SarIrAla	శరీరాల
SarIrAllO	శరీరాల్లో
SarIrAniki	శరీరానికి
SarIrAnnI	శరీరాన్నీ
SarIrAnni	శరీరాన్ని
SarIra	శరీర
SarIraM	శరీరం
SarIraMlO	శరీరంలో
SarIraMlOni	శరీరంలోని
SatAbdAla	శతాబ్దాల
SatAbdaM	శతాబ్దం
SatAbdaMlO	శతాబ్దంలో
SatAbdaMlOnE	శతాబ్దంలోనే
SatAbdi	శతాబ్ది
SataghaTAbhishEkaM	శతఘటాభిషేకం
SataliMgAla	శతలింగాల
SataliMgAlu	శతలింగాలు
SavAsanaM	శవాసనం
SibirAlu	శిబిరాలు
SikharamA	శిఖరమా
SikshaNa	శిక్షణ
SilpAlu	శిల్పాలు
SirasAsanaM	శిరసాసనం
Sirasu	శిరసు
SishTarakshaNakU	శిష్టరక్షణకూ
SivAlayaM	శివాలయం
SivAlayaMlO	శివాలయంలో
SivArcana	శివార్చన
Sivabhaktulu	శివభక్తులు
SivakESavulaku	శివకేశవులకు
SivakESavulu	శివకేశవులు
SivalADji	శివలాడ్జి
SivaliMgAlu	శివలింగాలు
SivaliMgAnni	శివలింగాన్ని
SivarAj	శివరాజ్
SivarAtri	శివరాత్రి
SivasattulaMTE	శివసత్తులంటే
SivasattulaitE	శివసత్తులైతే
Sivasattulanu	శివసత్తులను
Sivasattulu	శివసత్తులు
SivuDiki	శివుడికి
SivuNNi	శివుణ్ణి
SlOkAniki	శ్లోకానికి
SrEyO	శ్రేయో
SrI	శ్రీ
SrISailamannamATa	శ్రీశైలమన్నమాట
SrIhari	శ్రీహరి
SrIkAkuLAniki	శ్రీకాకుళానికి
SrIkAkuLESvara	శ్రీకాకుళేశ్వర
SrIkAkuLESvarasvAmi	శ్రీకాకుళేశ్వరస్వామి
SrIkAkuLa	శ్రీకాకుళ
SrIkAkuLaM	శ్రీకాకుళం
SrIkAkuLaMgA	శ్రీకాకుళంగా
SrIkAkuLaMlO	శ్రీకాకుళంలో
SrIkAkuLaMlOni	శ్రీకాకుళంలోని
SrIkAraM	శ్రీకారం
SrIkRshNadEvarAyalu	శ్రీకృష్ణదేవరాయలు
SrIkRshNalIlA	శ్రీకృష్ణలీలా
SrIkRshNuDu	శ్రీకృష్ణుడు
SrIlakshmInarasiMhasvAmi	శ్రీలక్ష్మీనరసింహస్వామి
SrImahAvishNuvunu	శ్రీమహావిష్ణువును
SrInAthuDu	శ్రీనాథుడు
SrInivAsuDani	శ్రీనివాసుడని
SrInivAsuDiki	శ్రీనివాసుడికి
SrInivAsuniki	శ్రీనివాసునికి
SrIrAjyalakshmI	శ్రీరాజ్యలక్ష్మీ
SrIsvAmi	శ్రీస్వామి
SrIvArE	శ్రీవారే
SrIvAri	శ్రీవారి
SrIvArimeTTu	శ్రీవారిమెట్టు
SrIvArini	శ్రీవారిని
SrIvAru	శ్రీవారు
SrIvEMkaTESvaruDu	శ్రీవేంకటేశ్వరుడు
SraddhAsaktula	శ్రద్ధాసక్తుల
Sraddha	శ్రద్ధ
Srama	శ్రమ
SramalEni	శ్రమలేని
SubhAlu	శుభాలు
Subhramaina	శుభ్రమైన
SuddhI	శుద్ధీ
SuddhicEsukuMTE	శుద్ధిచేసుకుంటే
Sukra	శుక్ర
SukravAraM	శుక్రవారం
SvAsa	శ్వాస
SvAsanu	శ్వాసను
SvAsapai	శ్వాసపై
SvAsatO	శ్వాసతో
TATA	టాటా
TAys	టాయ్స్
TI	టీ
TIcar	టీచర్
TIes	టీఎస్
TIvI	టీవీ
TIvIlu	టీవీలు
TOkenlanu	టోకెన్లను
TOl	టోల్
TUrijaM	టూరిజం
TairlU	టైర్లూ
Tenshan	టెన్షన్
TesTOsTirAn	టెస్టోస్టిరాన్
ThIvi	ఠీవి
Ti	టి
TikeT	టికెట్
TikeTTu	టికెట్టు
TikeTlalO	టికెట్లలో
TikeTlanu	టికెట్లను
TikeTlapai	టికెట్లపై
TikkeTTupai	టిక్కెట్టుపై
TikkeTla	టిక్కెట్ల
TikkeTlanu	టిక్కెట్లను
TrAvel	ట్రావెల్
TrAven	ట్రావెన్
TrasTIlu	ట్రస్టీలు
TyAksIlu	ట్యాక్సీలు
aDDoccinaTTu	అడ్డొచ్చినట్టు
aDDugA	అడ్డుగా
aDDugODa	అడ్డుగోడ
aDDugODalu	అడ్డుగోడలు
aDDukaTTalu	అడ్డుకట్టలు
aDavi	అడవి
aDavullO	అడవుల్లో
aDigAru	అడిగారు
aDigiMdi	అడిగింది
aDigitE	అడిగితే
aDugu	అడుగు
aDugula	అడుగుల
aDugulu	అడుగులు
aDugupeTTE	అడుగుపెట్టే
aDugupeTTinappuDu	అడుగుపెట్టినప్పుడు
aDugutIsi	అడుగుతీసి
aDugutuMdi	అడుగుతుంది
aDvAns	అడ్వాన్స్
aMD	అండ్
aMDASayAlu	అండాశయాలు
aMDaM	అండం
aMDagA	అండగా
aMSAlU	అంశాలూ
aMSAlanU	అంశాలనూ
aMSAlanu	అంశాలను
aMSAlapai	అంశాలపై
aMSAlatO	అంశాలతో
aMSaM	అంశం
aMSaMgA	అంశంగా
aMSamEnani	అంశమేనని
aMSamainA	అంశమైనా
aMSamaina	అంశమైన
aMSamani	అంశమని
aMSamannadi	అంశమన్నది
aMTAru	అంటారు
aMTE	అంటే
aMTU	అంటూ
aMTuMTAru	అంటుంటారు
aMTunnAM	అంటున్నాం
aMbAnI	అంబానీ
aMcanA	అంచనా
aMcanAlapai	అంచనాలపై
aMcanAlu	అంచనాలు
aMdAli	అందాలి
aMdE	అందే
aMdaM	అందం
aMdaMgA	అందంగా
aMdaTaM	అందటం
aMdajEstAru	అందజేస్తారు
aMdajEstOMdi	అందజేస్తోంది
aMdaka	అందక
aMdamaina	అందమైన
aMdarU	అందరూ
aMdarikI	అందరికీ
aMdaru	అందరు
aMdi	అంది
aMdiMcAlani	అందించాలని
aMdiMcAlsina	అందించాల్సిన
aMdiMcAru	అందించారు
aMdiMcE	అందించే
aMdiMcEMduku	అందించేందుకు
aMdiMcEvanI	అందించేవనీ
aMdiMcaTaM	అందించటం
aMdistE	అందిస్తే
aMdistOMdani	అందిస్తోందని
aMdistunnAru	అందిస్తున్నారు
aMdubATulO	అందుబాటులో
aMdubATulOki	అందుబాటులోకి
aMdukE	అందుకే
aMdukOvAlannadi	అందుకోవాలన్నది
aMdukani	అందుకని
aMdukoMTunnADu	అందుకొంటున్నాడు
aMduku	అందుకు
aMdukuMTOMdi	అందుకుంటోంది
aMdukuMTU	అందుకుంటూ
aMdulO	అందులో
aMdutuMDaTaMtO	అందుతుండటంతో
aMdutuMdi	అందుతుంది
aMduvalla	అందువల్ల
aMgAMga	అంగాంగ
aMgAla	అంగాల
aMgIkariMcE	అంగీకరించే
aMgIrasa	అంగీరస
aMga	అంగ
aMgaLlE	అంగళ్లే
aMgaM	అంగం
aMgapAluDi	అంగపాలుడి
aMgastaMbhana	అంగస్తంభన
aMgastaMbhanalO	అంగస్తంభనలో
aMgastaMbhanalaku	అంగస్తంభనలకు
aMkurArpaNa	అంకురార్పణ
aMtA	అంతా
aMtE	అంతే
aMtEgAnI	అంతేగానీ
aMtEkAdu	అంతేకాదు
aMta	అంత
aMtaTidi	అంతటిది
aMtakaMTE	అంతకంటే
aMtaku	అంతకు
aMtamoMdiMcina	అంతమొందించిన
aMtarbhAgAlavO	అంతర్భాగాలవో
aMtarjAlaM	అంతర్జాలం
aMtarjAlaMlO	అంతర్జాలంలో
aMtarjAtIya	అంతర్జాతీయ
aMtarlInaMgA	అంతర్లీనంగా
aMtarvAhini	అంతర్వాహిని
aMtarvAhinigA	అంతర్వాహినిగా
aMtasthulO	అంతస్థులో
aMtasthulOni	అంతస్థులోని
aMtasthulugA	అంతస్థులుగా
aMtimaMgA	అంతిమంగా
aMtubaTTalEdu	అంతుబట్టలేదు
aMtubaTTani	అంతుబట్టని
aNuvaNuvU	అణువణువూ
aSAMti	అశాంతి
aSAstrIyaMgAnE	అశాస్త్రీయంగానే
aSvatthanArAyaNa	అశ్వత్థనారాయణ
aTTaDugu	అట్టడుగు
aTu	అటు
abbAyi	అబ్బాయి
abbAyilaku	అబ్బాయిలకు
abhIshTaM	అభీష్టం
abhaMSubhaM	అభంశుభం
abhinaMdanIyulE	అభినందనీయులే
abhiprAyapaDDAyi	అభిప్రాయపడ్డాయి
abhishEkAdulni	అభిషేకాదుల్ని
abhishEkAnni	అభిషేకాన్ని
abhishEkaM	అభిషేకం
abhishEkistAru	అభిషేకిస్తారు
abhivRddhI	అభివృద్ధీ
abhivRddhi	అభివృద్ధి
abhivarNitamaiMdi	అభివర్ణితమైంది
abhyarthinI	అభ్యర్థినీ
abhyarthula	అభ్యర్థుల
acyutadEvarAyala	అచ్యుతదేవరాయల
acyutarAyalu	అచ్యుతరాయలు
adE	అదే
adEdO	అదేదో
adEvidhaMgA	అదేవిధంగా
adI	అదీ
adRSyaM	అదృశ్యం
adRSyamaina	అదృశ్యమైన
adRSyamaipOyADaTa	అదృశ్యమైపోయాడట
adRshTavaMtulu	అదృష్టవంతులు
adanaMgA	అదనంగా
adanapu	అదనపు
adbhuta	అద్భుత
adbhutaMgA	అద్భుతంగా
addegadulu	అద్దెగదులు
adhigamiMcoccani	అధిగమించొచ్చని
adhikAri	అధికారి
adhikArikamaina	అధికారికమైన
adhikArlaku	అధికార్లకు
adhikArulu	అధికారులు
adhika	అధిక
adhikaMgA	అధికంగా
adhikaMgAnO	అధికంగానో
adhinEta	అధినేత
adhipatulu	అధిపతులు
adhyayanAlaku	అధ్యయనాలకు
adhyayanAllO	అధ్యయనాల్లో
adhyayanAlu	అధ్యయనాలు
adhyayanaM	అధ్యయనం
adhyayanaMlO	అధ్యయనంలో
adi	అది
adupulO	అదుపులో
agastyESvaruDu	అగస్త్యేశ్వరుడు
agnidEvuDu	అగ్నిదేవుడు
agra	అగ్ర
agraSrENi	అగ్రశ్రేణి
ahObila	అహోబిల
ahObilaM	అహోబిలం
ahObilaMlO	అహోబిలంలో
ai	ఐ
aiTI	ఐటీ
aiTIIes	ఐటీఈఎస్
aidu	ఐదు
aidugurilO	ఐదుగురిలో
aien	ఐఎన్
aikyaM	ఐక్యం
aikyarAjyasamiti	ఐక్యరాజ్యసమితి
aitihyaM	ఐతిహ్యం
aivI	ఐవీ
ajJAnaM	అజ్ఞానం
akAla	అకాల
akauMTeMT	అకౌంటెంట్
akkaDE	అక్కడే
akkaDa	అక్కడ
akkaDi	అక్కడి
akkaNnuMci	అక్కణ్నుంచి
akkuna	అక్కున
akkunajErcukuMTOMdi	అక్కునజేర్చుకుంటోంది
akrama	అక్రమ
akshaya	అక్షయ
alA	అలా
alAMTappuDu	అలాంటప్పుడు
alAMTi	అలాంటి
alAgE	అలాగే
alAgani	అలాగని
alaMkArOtsavAlu	అలంకారోత్సవాలు
alaMkariMcina	అలంకరించిన
alarArE	అలరారే
alarjI	అలర్జీ
alasaTa	అలసట
alasipOtE	అలసిపోతే
alavATu	అలవాటు
alavOkagA	అలవోకగా
alavaDutuMdi	అలవడుతుంది
alipiri	అలిపిరి
alivElumaMga	అలివేలుమంగ
alluDaina	అల్లుడైన
allukunnAyi	అల్లుకున్నాయి
alpAhAraM	అల్పాహారం
amAMtaM	అమాంతం
amAvAsya	అమావాస్య
amIr	అమీర్
amOgha	అమోఘ
amalApurAniki	అమలాపురానికి
amarAvatilO	అమరావతిలో
amarESvaruDigA	అమరేశ్వరుడిగా
amarcE	అమర్చే
ammAyi	అమ్మాయి
ammAyilaku	అమ్మాయిలకు
ammAyillO	అమ్మాయిల్లో
ammAyini	అమ్మాయిని
ammAyitO	అమ్మాయితో
ammaku	అమ్మకు
ammavAri	అమ్మవారి
ammavArini	అమ్మవారిని
ammavArlaku	అమ్మవార్లకు
anAdi	అనాది
anAdigA	అనాదిగా
anArOgyAniki	అనారోగ్యానికి
anE	అనే
anEdi	అనేది
anEka	అనేక
anEkaM	అనేకం
anI	అనీ
anUhya	అనూహ్య
anUhyaMgA	అనూహ్యంగా
anaMtabhOgayya	అనంతభోగయ్య
anaMtaraM	అనంతరం
anaTaM	అనటం
anadu	అనదు
anagA	అనగా
anagAnE	అనగానే
anakUDadu	అనకూడదు
anavasaraMgA	అనవసరంగా
anavasaramaina	అనవసరమైన
anavasaramainavI	అనవసరమైనవీ
ani	అని
anipiMcElA	అనిపించేలా
anipiMcaTaM	అనిపించటం
anipiMciMdi	అనిపించింది
anipiMcinA	అనిపించినా
anipistuMDoccu	అనిపిస్తుండొచ్చు
anipistuMdi	అనిపిస్తుంది
anipistunnadi	అనిపిస్తున్నది
anirvacanIyamaina	అనిర్వచనీయమైన
anivAryamayyAyi	అనివార్యమయ్యాయి
annA	అన్నా
annAbhishEkaM	అన్నాభిషేకం
annAraTa	అన్నారట
annAru	అన్నారు
annI	అన్నీ
anna	అన్న
annadAna	అన్నదాన
annadi	అన్నది
annaprasAda	అన్నప్రసాద
annaprasAdaM	అన్నప్రసాదం
annavi	అన్నవి
annayya	అన్నయ్య
anni	అన్ని
anniMTikI	అన్నింటికీ
annicOTlA	అన్నిచోట్లా
anubaMdha	అనుబంధ
anubhUti	అనుభూతి
anubhUtikI	అనుభూతికీ
anubhavAla	అనుభవాల
anubhavAlu	అనుభవాలు
anubhavAnidE	అనుభవానిదే
anubhavAnni	అనుభవాన్ని
anubhavaM	అనుభవం
anubhavaMlO	అనుభవంలో
anugrahiMcina	అనుగ్రహించిన
anugrahistADani	అనుగ్రహిస్తాడని
anukOvaccu	అనుకోవచ్చు
anukUlamaina	అనుకూలమైన
anukuMTAM	అనుకుంటాం
anukunnA	అనుకున్నా
anukunnAru	అనుకున్నారు
anumAnAlu	అనుమానాలు
anumatiMcAlani	అనుమతించాలని
anumatiMcaru	అనుమతించరు
anumatistAru	అనుమతిస్తారు
anumatistOMdi	అనుమతిస్తోంది
anumatistuMdi	అనుమతిస్తుంది
anumatistunnAru	అనుమతిస్తున్నారు
anunayaMgA	అనునయంగా
anupamAna	అనుపమాన
anurAga	అనురాగ
anurakti	అనురక్తి
anuvaMSika	అనువంశిక
anuvaina	అనువైన
anvEshistuMdi	అన్వేషిస్తుంది
anyOnya	అన్యోన్య
anyOnyaMgA	అన్యోన్యంగా
anyOnyamaina	అన్యోన్యమైన
anyOnyata	అన్యోన్యత
anyamArgaM	అన్యమార్గం
apOhala	అపోహల
apOhallEni	అపోహల్లేని
apOhallO	అపోహల్లో
apOhallOkI	అపోహల్లోకీ
apOhalu	అపోహలు
apUrvamaina	అపూర్వమైన
apUrvasEvA	అపూర్వసేవా
apanammakAlu	అపనమ్మకాలు
apariSubhraMgA	అపరిశుభ్రంగా
apariSubhramanna	అపరిశుభ్రమన్న
appaTi	అప్పటి
appaTikE	అప్పటికే
appaTikasalu	అప్పటికసలు
appaTiki	అప్పటికి
appaTlO	అప్పట్లో
appaTnuMcI	అప్పట్నుంచీ
appuDE	అప్పుడే
ara	అర
aracEtini	అరచేతిని
aragaMTakU	అరగంటకూ
arakora	అరకొర
aramarikalu	అరమరికలు
aravai	అరవై
arcakulu	అర్చకులు
arcanAdulni	అర్చనాదుల్ని
arcana	అర్చన
arcanalu	అర్చనలు
arciMcADani	అర్చించాడని
arciMcEMduku	అర్చించేందుకు
arciMcina	అర్చించిన
arcistU	అర్చిస్తూ
ardhAMgi	అర్ధాంగి
ardha	అర్ధ
ardhaSarIrAnni	అర్ధశరీరాన్ని
arhulaina	అర్హులైన
arka	అర్క
arpiMcAlanI	అర్పించాలనీ
arpiMcE	అర్పించే
arpistAru	అర్పిస్తారు
arthaM	అర్థం
artharahita	అర్థరహిత
arthasatyAlu	అర్థసత్యాలు
arthavaMtamaina	అర్థవంతమైన
aruMdhatI	అరుంధతీ
aruMdhati	అరుంధతి
arudEM	అరుదేం
asAdhAraNa	అసాధారణ
asaMkalpita	అసంకల్పిత
asaMtRpti	అసంతృప్తి
asabhya	అసభ్య
asabhyataku	అసభ్యతకు
asahajamU	అసహజమూ
asalu	అసలు
asamAnamaina	అసమానమైన
asatyAlu	అసత్యాలు
asaukaryaM	అసౌకర్యం
ashTAdaSa	అష్టాదశ
ashTOttara	అష్టోత్తర
ashTadikpAlakulu	అష్టదిక్పాలకులు
asisTeMT	అసిస్టెంట్
asuruDu	అసురుడు
atanu	అతను
ati	అతి
atiSayamEM	అతిశయమేం
atigA	అతిగా
atikramiMcanaMta	అతిక్రమించనంత
atipedda	అతిపెద్ద
atithigRhAlu	అతిథిగృహాలు
atri	అత్రి
atyaMta	అత్యంత
atyadbhuta	అత్యద్భుత
atyadhika	అత్యధిక
atyavasara	అత్యవసర
atyavasaramaina	అత్యవసరమైన
aunnijamE	ఔన్నిజమే
aushadhaM	ఔషధం
aushadhaMgA	ఔషధంగా
avAMCita	అవాంఛిత
avE	అవే
avaSya	అవశ్య
avadhulu	అవధులు
avagAhanA	అవగాహనా
avagAhana	అవగాహన
avagAhanatO	అవగాహనతో
avakASAlU	అవకాశాలూ
avakASAlanu	అవకాశాలను
avakASAnni	అవకాశాన్ని
avakASaM	అవకాశం
avakASamuMdi	అవకాశముంది
avasarAlEMTO	అవసరాలేంటో
avasarAlanu	అవసరాలను
avasarAnni	అవసరాన్ని
avasarAnnibaTTi	అవసరాన్నిబట్టి
avasaraM	అవసరం
avasaramaina	అవసరమైన
avasaramaitE	అవసరమైతే
avasaramanE	అవసరమనే
avasaramanna	అవసరమన్న
avasaramanukuMTE	అవసరమనుకుంటే
avasaramavutAyi	అవసరమవుతాయి
avasaramuMTuMdi	అవసరముంటుంది
avasaramunnA	అవసరమున్నా
avatariMcabOtOMdi	అవతరించబోతోంది
avataristuMdanI	అవతరిస్తుందనీ
avayavAla	అవయవాల
avayavAlaku	అవయవాలకు
avayavAlatO	అవయవాలతో
avayava	అవయవ
avayavaM	అవయవం
avi	అవి
avunu	అవును
avutAyanI	అవుతాయనీ
avutAyani	అవుతాయని
avutAyanna	అవుతాయన్న
avutAyi	అవుతాయి
avutuMdi	అవుతుంది
avutunna	అవుతున్న
ayOmayaMgA	అయోమయంగా
ayi	అయి
ayiMdi	అయింది
ayidO	అయిదో
ayidu	అయిదు
ayinA	అయినా
ayina	అయిన
ayipOtuMdani	అయిపోతుందని
ayipOyiMdi	అయిపోయింది
ayitE	అయితే
ayyADu	అయ్యాడు
ayyE	అయ్యే
ayyEsariki	అయ్యేసరికి
ayyiMdi	అయ్యింది
bAMbElanu	బాంబేలను
bAMdhavyAlanu	బాంధవ్యాలను
bAMdhavya	బాంధవ్య
bAcEpallilO	బాచేపల్లిలో
bAdhE	బాధే
bAdha	బాధ
bAdhala	బాధల
bAdhalanu	బాధలను
bAdhalu	బాధలు
bAdhanu	బాధను
bAdhapaDaTaM	బాధపడటం
bAdhapaDutuMTE	బాధపడుతుంటే
bAdhistunna	బాధిస్తున్న
bAdhitula	బాధితుల
bAdhyatAyuta	బాధ్యతాయుత
bAdhyatAyutaMgA	బాధ్యతాయుతంగా
bAdhyatAyutamaina	బాధ్యతాయుతమైన
bAdhyatAyutamainadani	బాధ్యతాయుతమైనదని
bAdhyata	బాధ్యత
bAdhyatagA	బాధ్యతగా
bAdhyatalanu	బాధ్యతలను
bAdhyatalu	బాధ్యతలు
bAdhyatatO	బాధ్యతతో
bAgA	బాగా
bAgAnE	బాగానే
bAguMDAlaMTE	బాగుండాలంటే
bAguMTE	బాగుంటే
bAguMTuMdi	బాగుంటుంది
bAgunnAyA	బాగున్నాయా
bAjAlu	బాజాలు
bAlAjI	బాలాజీ
bAlyaM	బాల్యం
bAr	బార్
bArina	బారిన
bArinapaDaTaM	బారినపడటం
bArinapaDakuMDA	బారినపడకుండా
bAvi	బావి
bAvini	బావిని
bITI	బీటీ
bITIla	బీటీల
bITIlu	బీటీలు
bIai	బీఐ
bIaigA	బీఐగా
bIaiki	బీఐకి
bIailO	బీఐలో
bIbIjE	బీబీజే
bIbInAMcAri	బీబీనాంచారి
bIem	బీఎమ్
bIeph	బీఎఫ్
bIhec	బీహెచ్
bIjAlu	బీజాలు
bIpI	బీపీ
bIpIsIel	బీపీసీఎల్
bOdhana	బోధన
bOdhistunna	బోధిస్తున్న
bOleDu	బోలెడు
bOrDu	బోర్డు
bOyIlaMTAru	బోయీలంటారు
bRMdAnni	బృందాన్ని
bRgumaLla	బృగుమళ్ల
bRhat	బృహత్
bRhattara	బృహత్తర
bUTla	బూట్ల
bUtu	బూతు
baDilO	బడిలో
baDina	బడిన
baMDala	బండల
baMDarAyi	బండరాయి
baMdhAlanu	బంధాలను
baMdhAniki	బంధానికి
baMdhaM	బంధం
baMdhamE	బంధమే
baMdhanAllO	బంధనాల్లో
baMdhanAlu	బంధనాలు
baMdhumitrulatO	బంధుమిత్రులతో
baMgArAnni	బంగారాన్ని
baMgAraM	బంగారం
baMgAramainA	బంగారమైనా
baMgAru	బంగారు
baMgArutalli	బంగారుతల్లి
baTTE	బట్టే
baTTi	బట్టి
baddhakONAsanaM	బద్ధకోణాసనం
badilI	బదిలీ
baduliccEdi	బదులిచ్చేది
badulu	బదులు
bahaddUr	బహద్దూర్
bahiraMgaMgA	బహిరంగంగా
bahuLa	బహుళ
balAlU	బలాలూ
balAlanu	బలాలను
balAnikI	బలానికీ
balAniki	బలానికి
balIyamaina	బలీయమైన
balOpEtaM	బలోపేతం
balaMgA	బలంగా
balahInamavutuMdi	బలహీనమవుతుంది
balahInapaDutU	బలహీనపడుతూ
balahInata	బలహీనత
balahInatalU	బలహీనతలూ
balahInatala	బలహీనతల
balamaina	బలమైన
balapaDiMdi	బలపడింది
balaparustuMdani	బలపరుస్తుందని
balavaMtAna	బలవంతాన
balavaMtaMgA	బలవంతంగా
balkaMpETa	బల్కంపేట
balkaMpETagA	బల్కంపేటగా
balkaMpETanu	బల్కంపేటను
baruvu	బరువు
baruvunu	బరువును
basTAMDu	బస్టాండు
basacESAru	బసచేశారు
bassu	బస్సు
bassulO	బస్సులో
bassula	బస్సుల
bassulu	బస్సులు
bassulunnAyi	బస్సులున్నాయి
batikE	బతికే
bayaTakocci	బయటకొచ్చి
bayaTaku	బయటకు
bayaTapaDEMduku	బయటపడేందుకు
bayaTapaDatAyi	బయటపడతాయి
bayaTapaDiMdi	బయటపడింది
bayaTi	బయటి
bayaTiki	బయటికి
bayaldErA	బయల్దేరా
bayaldEri	బయల్దేరి
bayaldErutuMdi	బయల్దేరుతుంది
bayaldErutunnaTTu	బయల్దేరుతున్నట్టు
bayaludErADu	బయలుదేరాడు
bayaludEraDAnnE	బయలుదేరడాన్నే
bayaludEritE	బయలుదేరితే
bayalulA	బయలులా
beMbElettipOvaTaM	బెంబేలెత్తిపోవటం
beMgAl	బెంగాల్
behalUkhAn	బెహలూఖాన్
berukudanaM	బెరుకుదనం
bhAgAlakU	భాగాలకూ
bhAgAlaku	భాగాలకు
bhAgAlanu	భాగాలను
bhAgaM	భాగం
bhAgaMgA	భాగంగా
bhAgaMlO	భాగంలో
bhAgasvAmani	భాగస్వామని
bhAgasvAmi	భాగస్వామి
bhAgasvAmikI	భాగస్వామికీ
bhAgasvAmiki	భాగస్వామికి
bhAgasvAmilO	భాగస్వామిలో
bhAgasvAmini	భాగస్వామిని
bhAgasvAmitO	భాగస్వామితో
bhAgasvAmula	భాగస్వాముల
bhAgasvAmuliddarU	భాగస్వాములిద్దరూ
bhAgasvAmuliddarilO	భాగస్వాములిద్దరిలో
bhAgasvAmulu	భాగస్వాములు
bhAgasvAmyaM	భాగస్వామ్యం
bhAgyAnni	భాగ్యాన్ని
bhAgyaM	భాగ్యం
bhArI	భారీ
bhArat	భారత్
bhAratAMdhrIkaraNaku	భారతాంధ్రీకరణకు
bhAratIya	భారతీయ
bhArata	భారత
bhArataM	భారతం
bhAryatO	భార్యతో
bhAshalu	భాషలు
bhAti	భాతి
bhAvAllO	భావాల్లో
bhAvOdvEgAla	భావోద్వేగాల
bhAvOdvEgAlakU	భావోద్వేగాలకూ
bhAvOdvEgAllO	భావోద్వేగాల్లో
bhAvOdvEga	భావోద్వేగ
bhAvana	భావన
bhAvanalO	భావనలో
bhAvanalU	భావనలూ
bhAvanala	భావనల
bhAvanalanu	భావనలను
bhAvanallOkI	భావనల్లోకీ
bhAvanalu	భావనలు
bhAvananu	భావనను
bhAvanatO	భావనతో
bhAvavyaktIkaraNa	భావవ్యక్తీకరణ
bhAviMcAru	భావించారు
bhAviMcE	భావించే
bhAviMcaTaM	భావించటం
bhAviMcalEM	భావించలేం
bhAviMci	భావించి
bhAviMcina	భావించిన
bhAvistAru	భావిస్తారు
bhAvistU	భావిస్తూ
bhAvistuMTAru	భావిస్తుంటారు
bhAvistunnAru	భావిస్తున్నారు
bhAvistunnaTTu	భావిస్తున్నట్టు
bhEdaM	భేదం
bhEshajAlU	భేషజాలూ
bhImESvarAlayAniki	భీమేశ్వరాలయానికి
bhImESvarAlayaM	భీమేశ్వరాలయం
bhImESvara	భీమేశ్వర
bhImESvaramUrtini	భీమేశ్వరమూర్తిని
bhImESvarapaTTaNE	భీమేశ్వరపట్టణే
bhImESvarasvAmini	భీమేశ్వరస్వామిని
bhImESvaruDi	భీమేశ్వరుడి
bhImESvaruDikI	భీమేశ్వరుడికీ
bhImESvaruDiki	భీమేశ్వరుడికి
bhImESvaruDini	భీమేశ్వరుడిని
bhImESvaruDu	భీమేశ్వరుడు
bhImESvaruDugA	భీమేశ్వరుడుగా
bhImESvaruDulAMTi	భీమేశ్వరుడులాంటి
bhImESvaruNNi	భీమేశ్వరుణ్ణి
bhImESvarulni	భీమేశ్వరుల్ని
bhIma	భీమ
bhImakhaMDaM	భీమఖండం
bhImarUpaMlO	భీమరూపంలో
bhImasabha	భీమసభ
bhImavaraM	భీమవరం
bhImuDu	భీముడు
bhOjanAnni	భోజనాన్ని
bhOjanaM	భోజనం
bhRgu	భృగు
bhU	భూ
bhUlOkAniki	భూలోకానికి
bhUlOkaMlO	భూలోకంలో
bhUlakshmi	భూలక్ష్మి
bhUmigA	భూమిగా
bhUmini	భూమిని
bhUmipai	భూమిపై
bhUri	భూరి
bhUtO	భూతో
bhUtakAlaMlO	భూతకాలంలో
bhUtanAthuDu	భూతనాథుడు
bhUtaprEtapiSAcAdi	భూతప్రేతపిశాచాది
bhaMgaM	భంగం
bhaMgimalO	భంగిమలో
bhaMgimallO	భంగిమల్లో
bhaTTArakuDu	భట్టారకుడు
bhadratA	భద్రతా
bhadratAvalayaMlO	భద్రతావలయంలో
bhaktajanaM	భక్తజనం
bhaktajanulanU	భక్తజనులనూ
bhaktajanulu	భక్తజనులు
bhaktakOTi	భక్తకోటి
bhakti	భక్తి
bhaktiSraddhalatO	భక్తిశ్రద్ధలతో
bhaktitO	భక్తితో
bhaktula	భక్తుల
bhaktulaMdarikI	భక్తులందరికీ
bhaktulaku	భక్తులకు
bhaktulanu	భక్తులను
bhaktulni	భక్తుల్ని
bhaktulu	భక్తులు
bhalE	భలే
bharatakhaMDa	భరతఖండ
bhariMcalEni	భరించలేని
bharta	భర్త
bhartaku	భర్తకు
bhasmIpaTalaM	భస్మీపటలం
bhavishyati	భవిష్యతి
bhavishyattu	భవిష్యత్తు
bhavishyattukU	భవిష్యత్తుకూ
bhavishyattulO	భవిష్యత్తులో
bhavya	భవ్య
bhayAla	భయాల
bhayAllO	భయాల్లో
bhayAllOnU	భయాల్లోనూ
bhayAlu	భయాలు
bhayAnni	భయాన్ని
bhayaM	భయం
bhayaMtOnE	భయంతోనే
bhayabhrAMtulaku	భయభ్రాంతులకు
bhayamEsiMdi	భయమేసింది
bhinnaMgA	భిన్నంగా
bhinnamainadi	భిన్నమైనది
bhramallOnU	భ్రమల్లోనూ
bhujaskaMdAlapai	భుజస్కందాలపై
biDiyaM	బిడియం
bigapaTTi	బిగపట్టి
bikanEr	బికనేర్
biliyan	బిలియన్
boDipellO	బొడిపెల్లో
boDipelu	బొడిపెలు
boTana	బొటన
bommala	బొమ్మల
bommalakU	బొమ్మలకూ
bommalu	బొమ్మలు
bommanu	బొమ్మను
brAhmaNuDi	బ్రాహ్మణుడి
brAlanu	బ్రాలను
brAlu	బ్రాలు
brAnu	బ్రాను
brahmAMDE	బ్రహ్మాండే
brahmAMDaMlO	బ్రహ్మాండంలో
brahmE	బ్రహ్మే
brahmOtsavAlU	బ్రహ్మోత్సవాలూ
brahmOtsavAla	బ్రహ్మోత్సవాల
brahmOtsavAlaku	బ్రహ్మోత్సవాలకు
brahmOtsavAllO	బ్రహ్మోత్సవాల్లో
brahmOtsavAlu	బ్రహ్మోత్సవాలు
brahma	బ్రహ్మ
brahmadEvuni	బ్రహ్మదేవుని
brahmaku	బ్రహ్మకు
brahmatO	బ్రహ్మతో
bretiMg	బ్రెతింగ్
briTIshu	బ్రిటీషు
buddhinI	బుద్ధినీ
buk	బుక్
bukiMg	బుకింగ్
burra	బుర్ర
burrallO	బుర్రల్లో
burranu	బుర్రను
byAMk	బ్యాంక్
byAMkiMg	బ్యాంకింగ్
byAMku	బ్యాంకు
byAMkula	బ్యాంకుల
byAMkulaku	బ్యాంకులకు
byAMkullO	బ్యాంకుల్లో
byAMkulu	బ్యాంకులు
cALukya	చాళుక్య
cALukyulatO	చాళుక్యులతో
cATumATu	చాటుమాటు
cAlA	చాలా
cAlAmaMdi	చాలామంది
cAlAmaMdiki	చాలామందికి
cAlAsArlu	చాలాసార్లు
cAlAsEpE	చాలాసేపే
cAlavu	చాలవు
cAllEdu	చాల్లేదు
cAlu	చాలు
cApanu	చాపను
cAritraka	చారిత్రక
cAritrakaMgAnU	చారిత్రకంగానూ
cAvu	చావు
cCI	చ్ఛీ
cESADaTa	చేశాడట
cESADanI	చేశాడనీ
cESAka	చేశాక
cESAnani	చేశానని
cESAranI	చేశారనీ
cESAru	చేశారు
cESAyi	చేశాయి
cEkUrcE	చేకూర్చే
cEkUrustuMdi	చేకూరుస్తుంది
cEpaTTi	చేపట్టి
cEpaTTiMdi	చేపట్టింది
cEraDaMtO	చేరడంతో
cEravEstuMdi	చేరవేస్తుంది
cErcAlani	చేర్చాలని
cErcukuMTAranI	చేర్చుకుంటారనీ
cErukOvAlaMTE	చేరుకోవాలంటే
cErukOvAli	చేరుకోవాలి
cErukOvaDAniki	చేరుకోవడానికి
cErukOvaccu	చేరుకోవచ్చు
cErukoMTuMdanI	చేరుకొంటుందనీ
cErukonE	చేరుకొనే
cErukoni	చేరుకొని
cErukunE	చేరుకునే
cErutuMdi	చేరుతుంది
cEsE	చేసే
cEsEdE	చేసేదే
cEsEdEM	చేసేదేం
cEsElA	చేసేలా
cEsEvALlanu	చేసేవాళ్లను
cEsEvAri	చేసేవారి
cEsEvArilO	చేసేవారిలో
cEsEvAru	చేసేవారు
cEsEvi	చేసేవి
cEsi	చేసి
cEsiMdaTa	చేసిందట
cEsiMdi	చేసింది
cEsinA	చేసినా
cEsina	చేసిన
cEstADu	చేస్తాడు
cEstAmO	చేస్తామో
cEstAru	చేస్తారు
cEstAyi	చేస్తాయి
cEstE	చేస్తే
cEstOMdi	చేస్తోంది
cEstU	చేస్తూ
cEstuMTAru	చేస్తుంటారు
cEstuMdani	చేస్తుందని
cEstuMdi	చేస్తుంది
cEstunnAru	చేస్తున్నారు
cEstunna	చేస్తున్న
cEstunnaTTE	చేస్తున్నట్టే
cEstunnappuDu	చేస్తున్నప్పుడు
cEsukOkapOtE	చేసుకోకపోతే
cEsukOvAlaMTE	చేసుకోవాలంటే
cEsukOvAlsi	చేసుకోవాల్సి
cEsukOvaDaM	చేసుకోవడం
cEsukOvaTaM	చేసుకోవటం
cEsukOvaTaMlO	చేసుకోవటంలో
cEsukOvaccu	చేసుకోవచ్చు
cEsukoMTuMdi	చేసుకొంటుంది
cEsukoni	చేసుకొని
cEsukonna	చేసుకొన్న
cEsukuMTAM	చేసుకుంటాం
cEsukuMTAru	చేసుకుంటారు
cEsukuMTE	చేసుకుంటే
cEsukuMTOMdi	చేసుకుంటోంది
cEsukuMTU	చేసుకుంటూ
cEsukuMTuMdi	చేసుకుంటుంది
cEsukuMTunna	చేసుకుంటున్న
cEsukuMdAM	చేసుకుందాం
cEsukunE	చేసుకునే
cEsukunEMduku	చేసుకునేందుకు
cEsukunElA	చేసుకునేలా
cEsukuni	చేసుకుని
cEsukunna	చేసుకున్న
cEti	చేతి
cEtiki	చేతికి
cEtikoccE	చేతికొచ్చే
cEtikoccinaTTu	చేతికొచ్చినట్టు
cEtiniMDA	చేతినిండా
cEtuletti	చేతులెత్తి
cEtulu	చేతులు
cEyAlanEdAniki	చేయాలనేదానికి
cEyAlani	చేయాలని
cEyAlanukunnAru	చేయాలనుకున్నారు
cEyAli	చేయాలి
cEyAlsi	చేయాల్సి
cEyaDAniki	చేయడానికి
cEyaDaM	చేయడం
cEyaMDi	చేయండి
cEyaTAniki	చేయటానికి
cEyaTaM	చేయటం
cEyagA	చేయగా
cEyakUDadu	చేయకూడదు
cEyakapOyinA	చేయకపోయినా
cEyamaMdi	చేయమంది
cEyamani	చేయమని
cEyarAdu	చేయరాదు
cEyi	చేయి
cEyiMcaTaM	చేయించటం
cEyiMci	చేయించి
cEyiMcukunnappuDu	చేయించుకున్నప్పుడు
cEyistAru	చేయిస్తారు
cEyoccu	చేయొచ్చు
cIdariMcukOvAlsina	చీదరించుకోవాల్సిన
cIdariMcukunE	చీదరించుకునే
cIkaTi	చీకటి
cIkaTitO	చీకటితో
cIkaTlO	చీకట్లో
cIlcukuni	చీల్చుకుని
cOLa	చోళ
cOLula	చోళుల
cOLulu	చోళులు
cOTa	చోట
cOTu	చోటు
cUDAlanE	చూడాలనే
cUDAlanna	చూడాలన్న
cUDDAniki	చూడ్డానికి
cUDaMDi	చూడండి
cUDaTAniki	చూడటానికి
cUDaTaM	చూడటం
cUDaTamannadi	చూడటమన్నది
cUDalEM	చూడలేం
cUDani	చూడని
cUSAnrA	చూశాన్రా
cUSArAme	చూశారామె
cUpi	చూపి
cUpiMcaDaM	చూపించడం
cUpiMcaTaM	చూపించటం
cUpiMcalEka	చూపించలేక
cUpiMci	చూపించి
cUpistAru	చూపిస్తారు
cUpistU	చూపిస్తూ
cUpistunna	చూపిస్తున్న
cUpula	చూపుల
cUputAyani	చూపుతాయని
cUputippanivvavu	చూపుతిప్పనివ్వవు
cUputuMTAM	చూపుతుంటాం
cUputuMdi	చూపుతుంది
cUsE	చూసే
cUsi	చూసి
cUsinA	చూసినా
cUsina	చూసిన
cUsinapuDu	చూసినపుడు
cUstE	చూస్తే
cUstU	చూస్తూ
cUstUnE	చూస్తూనే
cUstuMDEvALlu	చూస్తుండేవాళ్లు
cUstuMDaTaM	చూస్తుండటం
cUstuMdi	చూస్తుంది
cUstunnAM	చూస్తున్నాం
cUsukOvaccu	చూసుకోవచ్చు
cUsukuMTAM	చూసుకుంటాం
cUsukunE	చూసుకునే
caMDISvarAdi	చండీశ్వరాది
caMdanOtsavaM	చందనోత్సవం
caMdrabAbu	చంద్రబాబు
caMdruDu	చంద్రుడు
caMpEstAru	చంపేస్తారు
caTTabaddhamaina	చట్టబద్ధమైన
caTukkuna	చటుక్కున
cadivAnanI	చదివాననీ
cadivO	చదివో
cadivi	చదివి
cadivina	చదివిన
caduvu	చదువు
caduvuku	చదువుకు
caduvukunEMduku	చదువుకునేందుకు
caduvutAM	చదువుతాం
cainAnU	చైనానూ
caitanya	చైతన్య
caitanyaM	చైతన్యం
caitra	చైత్ర
caitramAsaMlO	చైత్రమాసంలో
cakkaTi	చక్కటి
cakkagA	చక్కగా
cakkanicukka	చక్కనిచుక్క
cakraMtO	చక్రంతో
cakratIrthamani	చక్రతీర్థమని
cakravarti	చక్రవర్తి
caliMcipOyAru	చలించిపోయారు
callani	చల్లని
callapalli	చల్లపల్లి
canipOyADu	చనిపోయాడు
cappabaDipOyi	చప్పబడిపోయి
caritra	చరిత్ర
caritralO	చరిత్రలో
caritralOnE	చరిత్రలోనే
carmAniki	చర్మానికి
carmaM	చర్మం
carmarugmatalu	చర్మరుగ్మతలు
carya	చర్య
caryala	చర్యల
caryalu	చర్యలు
caturdaSini	చతుర్దశిని
caturmakha	చతుర్మఖ
caturmukha	చతుర్ముఖ
ceDDa	చెడ్డ
ceDDapani	చెడ్డపని
ceMculakshmi	చెంచులక్ష్మి
ceMculu	చెంచులు
ceMdAraTa	చెందారట
ceMdiMdi	చెందింది
ceMdina	చెందిన
ceMdinavi	చెందినవి
ceMta	చెంత
cebutAru	చెబుతారు
cebutAyi	చెబుతాయి
cebutOMdi	చెబుతోంది
cebutuMTE	చెబుతుంటే
cebutunnAru	చెబుతున్నారు
cebutunnAyi	చెబుతున్నాయి
cekkalatO	చెక్కలతో
cekki	చెక్కి
cekkucedaraTaM	చెక్కుచెదరటం
celAkIgA	చెలాకీగా
celliMci	చెల్లించి
celliMcukuMTE	చెల్లించుకుంటే
cemaTanu	చెమటను
cemaTlu	చెమట్లు
ceppA	చెప్పా
ceppADaTa	చెప్పాడట
ceppAlaMTE	చెప్పాలంటే
ceppAli	చెప్పాలి
ceppAru	చెప్పారు
ceppE	చెప్పే
ceppEMduku	చెప్పేందుకు
ceppESAmani	చెప్పేశామని
ceppEvALlu	చెప్పేవాళ్లు
ceppaDAniki	చెప్పడానికి
ceppaDaM	చెప్పడం
ceppaDaMtO	చెప్పడంతో
ceppaTaM	చెప్పటం
ceppakOlEka	చెప్పకోలేక
ceppaka	చెప్పక
ceppalEni	చెప్పలేని
ceppiMdi	చెప్పింది
ceppinaTTu	చెప్పినట్టు
ceppukOlEkapOyinA	చెప్పుకోలేకపోయినా
ceppukuMTAru	చెప్పుకుంటారు
ceppulu	చెప్పులు
ceptOMdi	చెప్తోంది
ceptunnAyi	చెప్తున్నాయి
cey	చెయ్
ceyyAlO	చెయ్యాలో
ceyyAli	చెయ్యాలి
ceyyaTAniki	చెయ్యటానికి
ceyyaTaM	చెయ్యటం
ceyyagalugutuMTAM	చెయ్యగలుగుతుంటాం
ceyyakapOtE	చెయ్యకపోతే
ceyyalEni	చెయ్యలేని
ceyyi	చెయ్యి
ceyyoccu	చెయ్యొచ్చు
ciMtalEkuMDA	చింతలేకుండా
ciMtalu	చింతలు
ciTTA	చిట్టా
ciTliMcukunEvAru	చిట్లించుకునేవారు
cikAku	చికాకు
cikitsA	చికిత్సా
cikitsa	చికిత్స
cikitsakE	చికిత్సకే
cikitsalanu	చికిత్సలను
cikitsalu	చికిత్సలు
cikkaTi	చిక్కటి
cikkukupOtuMTuMdi	చిక్కుకుపోతుంటుంది
cikkukupOyi	చిక్కుకుపోయి
cinna	చిన్న
cinnacUpu	చిన్నచూపు
cinnacinna	చిన్నచిన్న
cinnadi	చిన్నది
cinnanATi	చిన్ననాటి
cinnapATi	చిన్నపాటి
cinnapaMdirilA	చిన్నపందిరిలా
cinnapillalu	చిన్నపిల్లలు
cinnatanaM	చిన్నతనం
cinnavayasulOnE	చిన్నవయసులోనే
cirutiLla	చిరుతిళ్ల
citrAla	చిత్రాల
citramaiMdaMTE	చిత్రమైందంటే
cittUrula	చిత్తూరుల
civara	చివర
civarigA	చివరిగా
civariki	చివరికి
coppuna	చొప్పున
cuTTADu	చుట్టాడు
cuTTArani	చుట్టారని
cuTTU	చుట్టూ
cuTTarikaM	చుట్టరికం
cuTTupakkala	చుట్టుపక్కల
curuku	చురుకు
curukudanaM	చురుకుదనం
curukugA	చురుకుగా
dAMpatya	దాంపత్య
dAMpatyaM	దాంపత్యం
dAMpatyaMlOnU	దాంపత్యంలోనూ
dAMtO	దాంతో
dAMtOnE	దాంతోనే
dATAlsi	దాటాల్సి
dATEMta	దాటేంత
dATi	దాటి
dATipOyAM	దాటిపోయాం
dAcEstunnAM	దాచేస్తున్నాం
dAcukuMTAM	దాచుకుంటాం
dAdApu	దాదాపు
dAdApugA	దాదాపుగా
dAguDumUtalE	దాగుడుమూతలే
dAhaM	దాహం
dAkshArAmaM	దాక్షారామం
dAkshAyaNi	దాక్షాయణి
dAnaM	దానం
dAnarthaM	దానర్థం
dAni	దాని
dAnidE	దానిదే
dAnikOsaM	దానికోసం
dAniki	దానికి
dAnilO	దానిలో
dAnipai	దానిపై
dAnitO	దానితో
dAnlO	దాన్లో
dAnnO	దాన్నో
dAnni	దాన్ని
dAnnuMci	దాన్నుంచి
dAparikAlU	దాపరికాలూ
dAparikAlu	దాపరికాలు
dAri	దారి
dArilO	దారిలో
dArinapOyE	దారినపోయే
dAritIsE	దారితీసే
dAritIsiMdi	దారితీసింది
dAritIstuMdi	దారితీస్తుంది
dAritiyyaccu	దారితియ్యచ్చు
dAruDhyAniki	దారుఢ్యానికి
dAruDhyAnni	దారుఢ్యాన్ని
dAruDhyaM	దారుఢ్యం
dAruNAlu	దారుణాలు
dAruNaMgA	దారుణంగా
dArula	దారుల
dAsOtsavaM	దాసోత్సవం
dAtalni	దాతల్ని
dAyakamainadani	దాయకమైనదని
dESAlanu	దేశాలను
dESAllO	దేశాల్లో
dESAnni	దేశాన్ని
dESaM	దేశం
dESaMlO	దేశంలో
dESaMlOnE	దేశంలోనే
dESaMlOni	దేశంలోని
dEhAnnI	దేహాన్నీ
dEni	దేని
dEniki	దేనికి
dEnimIdainA	దేనిమీదైనా
dEnnI	దేన్నీ
dEvAlayAla	దేవాలయాల
dEvAlayAnni	దేవాలయాన్ని
dEvAlaya	దేవాలయ
dEvAlayaM	దేవాలయం
dEvIdEvatAmUrtulU	దేవీదేవతామూర్తులూ
dEvO	దేవో
dEva	దేవ
dEvadAsi	దేవదాసి
dEvadEvuDu	దేవదేవుడు
dEvarakoMDa	దేవరకొండ
dEvasthAnaM	దేవస్థానం
dEvasthAnamE	దేవస్థానమే
dEvata	దేవత
dEvatalaMtA	దేవతలంతా
dEvatalanu	దేవతలను
dEvatalnI	దేవతల్నీ
dEvatalu	దేవతలు
dEvi	దేవి
dEvuDu	దేవుడు
dIMtO	దీంతో
dInarthaM	దీనర్థం
dIni	దీని
dInikOsaM	దీనికోసం
dIniki	దీనికి
dInipai	దీనిపై
dInivalla	దీనివల్ల
dInni	దీన్ని
dInnoka	దీన్నొక
dIpAlanU	దీపాలనూ
dIpAlu	దీపాలు
dIpAvaLi	దీపావళి
dIrghakAla	దీర్ఘకాల
dIrghakAlika	దీర్ఘకాలిక
dOhadaM	దోహదం
dRDhaMgA	దృఢంగా
dRDhatvAniki	దృఢత్వానికి
dRSyAlu	దృశ్యాలు
dRSyAnni	దృశ్యాన్ని
dRkpathaM	దృక్పథం
dRkpathaMtO	దృక్పథంతో
dRkpathamE	దృక్పథమే
dRshTi	దృష్టి
dRshTilO	దృష్టిలో
dRshTipeTTaDaM	దృష్టిపెట్టడం
dRshTitO	దృష్టితో
dUdipiMjallA	దూదిపింజల్లా
dUkutuMdi	దూకుతుంది
dUraMgA	దూరంగా
dUraMlO	దూరంలో
dUramai	దూరమై
dUramaipOtU	దూరమైపోతూ
daMDigA	దండిగా
daMDigAnE	దండిగానే
daMgEru	దంగేరు
daMpatulaku	దంపతులకు
daMpatulu	దంపతులు
daSAbdAla	దశాబ్దాల
daSAbdAlu	దశాబ్దాలు
daSa	దశ
daSagAnE	దశగానే
daSalOnE	దశలోనే
daSalOnU	దశలోనూ
daSalanu	దశలను
daSaluMTAyi	దశలుంటాయి
daSanu	దశను
daggarE	దగ్గరే
daggara	దగ్గర
daggaragA	దగ్గరగా
daggaraku	దగ్గరకు
daggaralOni	దగ్గరలోని
daggariki	దగ్గరికి
daggarnuMcI	దగ్గర్నుంచీ
daggu	దగ్గు
dainaMdina	దైనందిన
daivaM	దైవం
daivanirNayAnni	దైవనిర్ణయాన్ని
dakkAli	దక్కాలి
dakkAlsinaMta	దక్కాల్సినంత
dakkEdi	దక్కేది
dakkakuMDA	దక్కకుండా
dakkutAyA	దక్కుతాయా
dakkutAyaMTOMdi	దక్కుతాయంటోంది
dakkutAyani	దక్కుతాయని
dakkutAyi	దక్కుతాయి
dakkutOMdi	దక్కుతోంది
dakkutunnAyi	దక్కుతున్నాయి
dakshArAmaM	దక్షారామం
daksha	దక్ష
dakshaprajApati	దక్షప్రజాపతి
dakshavATika	దక్షవాటిక
dakshavATikagA	దక్షవాటికగా
dakshavATikaku	దక్షవాటికకు
dakshavATikalO	దక్షవాటికలో
dakshavATikalOni	దక్షవాటికలోని
dakshayajJAnni	దక్షయజ్ఞాన్ని
dakshiNa	దక్షిణ
dannugA	దన్నుగా
darSamiccina	దర్శమిచ్చిన
darSan	దర్శన్
darSanAla	దర్శనాల
darSanAlanu	దర్శనాలను
darSanAnaMtaraM	దర్శనానంతరం
darSanAniki	దర్శనానికి
darSanIyaM	దర్శనీయం
darSana	దర్శన
darSanaM	దర్శనం
darSanaMtO	దర్శనంతో
darSanabhAgyaM	దర్శనభాగ్యం
darSanamistADu	దర్శనమిస్తాడు
darSanamistAyi	దర్శనమిస్తాయి
darSanamistuMdi	దర్శనమిస్తుంది
darSanavELalu	దర్శనవేళలు
darSanimistAyi	దర్శనిమిస్తాయి
darSiMcAranI	దర్శించారనీ
darSiMcEMduku	దర్శించేందుకు
darSiMcagalaM	దర్శించగలం
darSiMcukOvAlani	దర్శించుకోవాలని
darSiMcukOvAlanna	దర్శించుకోవాలన్న
darSiMcukOvAli	దర్శించుకోవాలి
darSiMcukOvaDaM	దర్శించుకోవడం
darSiMcukOvaccu	దర్శించుకోవచ్చు
darSiMcukuMTE	దర్శించుకుంటే
darSiMcukunE	దర్శించుకునే
darSiMcukuni	దర్శించుకుని
darSiMcukunnAru	దర్శించుకున్నారు
darSiMcukunnaMta	దర్శించుకున్నంత
darSistE	దర్శిస్తే
darSistU	దర్శిస్తూ
darijErakuMDA	దరిజేరకుండా
darijEravannadi	దరిజేరవన్నది
darijEravu	దరిజేరవు
davanaMtO	దవనంతో
debbatiMTuMdi	దెబ్బతింటుంది
dhAmaM	ధామం
dhAnyAnni	ధాన్యాన్ని
dhArALaMgA	ధారాళంగా
dhArmikula	ధార్మికుల
dhArmikulaku	ధార్మికులకు
dhArmikulu	ధార్మికులు
dhAtuvu	ధాతువు
dhOraNi	ధోరణి
dhOraNilO	ధోరణిలో
dhOraNilOnE	ధోరణిలోనే
dhOraNitO	ధోరణితో
dhOraNulU	ధోరణులూ
dhOraNulanu	ధోరణులను
dhOraNulu	ధోరణులు
dhRvIkariMcinaTlu	ధృవీకరించినట్లు
dhairyaM	ధైర్యం
dhamanulu	ధమనులు
dhanika	ధనిక
dhanikulanuMcayitE	ధనికులనుంచయితే
dhaniyAlU	ధనియాలూ
dhara	ధర
dharakE	ధరకే
dharapai	ధరపై
dharatO	ధరతో
dhariMcAli	ధరించాలి
dhariMca	ధరించ
dhariMcani	ధరించని
dhariMci	ధరించి
dhariMcina	ధరించిన
dharmAlu	ధర్మాలు
dharma	ధర్మ
dharmakartalugA	ధర్మకర్తలుగా
dharmapatni	ధర్మపత్ని
dhruvIkaraNa	ధ్రువీకరణ
dhruvIkariMciMdi	ధ్రువీకరించింది
dhvajArOhaNa	ధ్వజారోహణ
dhvajastaMbhaM	ధ్వజస్తంభం
dhyAnaM	ధ్యానం
diMDu	దిండు
diSagA	దిశగా
dibbalA	దిబ్బలా
diddutArEmO	దిద్దుతారేమో
digainA	దిగైనా
digajAripOtunnAM	దిగజారిపోతున్నాం
diggaja	దిగ్గజ
digostArani	దిగొస్తారని
digulu	దిగులు
digutuMdi	దిగుతుంది
digutunnAru	దిగుతున్నారు
diguva	దిగువ
diguvaku	దిగువకు
dillI	దిల్లీ
dillIlOni	దిల్లీలోని
dinOtsavAnni	దినోత్సవాన్ని
dinacarya	దినచర్య
divyadarSanaM	దివ్యదర్శనం
divyasannidhi	దివ్యసన్నిధి
dorikipOtE	దొరికిపోతే
dorukutuMdi	దొరుకుతుంది
drAkshArAmAniki	ద్రాక్షారామానికి
drAkshArAmAnni	ద్రాక్షారామాన్ని
drAkshArAma	ద్రాక్షారామ
drAkshArAmaM	ద్రాక్షారామం
drAkshArAmaMlO	ద్రాక్షారామంలో
drAkshArAmaMlOni	ద్రాక్షారామంలోని
dravya	ద్రవ్య
duHkhaM	దుఃఖం
dukANAlU	దుకాణాలూ
dukANAlanu	దుకాణాలను
dukANAlu	దుకాణాలు
duppaTi	దుప్పటి
durabhiprAyAlannI	దురభిప్రాయాలన్నీ
duradRshTavaSAttU	దురదృష్టవశాత్తూ
durardhAlu	దురర్ధాలు
duravagAhanallO	దురవగాహనల్లో
durvAsana	దుర్వాసన
dushTaSaktulu	దుష్టశక్తులు
dushTaSikshaNakU	దుష్టశిక్షణకూ
dushpariNAmAla	దుష్పరిణామాల
dustulanu	దుస్తులను
dustulu	దుస్తులు
dvArA	ద్వారా
dvArAnO	ద్వారానో
dvaMdvanIti	ద్వంద్వనీతి
e	ఎ
eDamogaM	ఎడమొగం
eDyukEshan	ఎడ్యుకేషన్
eMDa	ఎండ
eMDaki	ఎండకి
eMcukOvAli	ఎంచుకోవాలి
eMcukoni	ఎంచుకొని
eMdarO	ఎందరో
eMdarinO	ఎందరినో
eMdukU	ఎందుకూ
eMdukaMTE	ఎందుకంటే
eMdukilA	ఎందుకిలా
eMduku	ఎందుకు
eMeMTIes	ఎంఎంటీఎస్
eMjIbIes	ఎంజీబీఎస్
eMpika	ఎంపిక
eMtO	ఎంతో
eMtOkoMta	ఎంతోకొంత
eMtOmaMdi	ఎంతోమంది
eMtOmaMdiki	ఎంతోమందికి
eMta	ఎంత
eMtaTi	ఎంతటి
eMtagAnO	ఎంతగానో
eMtakI	ఎంతకీ
eMtakU	ఎంతకూ
eTu	ఎటు
eTuvaMTi	ఎటువంటి
eduravutunna	ఎదురవుతున్న
edurayyE	ఎదురయ్యే
edurkoMTAranI	ఎదుర్కొంటారనీ
edurkoMTuMDagA	ఎదుర్కొంటుండగా
edurkoMTunna	ఎదుర్కొంటున్న
edurkonE	ఎదుర్కొనే
edurkonElA	ఎదుర్కొనేలా
edurocciMdi	ఎదురొచ్చింది
edurugAli	ఎదురుగాలి
edurugAnE	ఎదురుగానే
egjikyUTiv	ఎగ్జిక్యూటివ్
eguva	ఎగువ
ekarAlakupai	ఎకరాలకుపై
ekkaDA	ఎక్కడా
ekkaDO	ఎక్కడో
ekkaDa	ఎక్కడ
ekkaDainA	ఎక్కడైనా
ekkaDekkaDi	ఎక్కడెక్కడి
ekkaDuMdO	ఎక్కడుందో
ekkiMci	ఎక్కించి
ekkuva	ఎక్కువ
ekkuvagA	ఎక్కువగా
ekkuvagAnE	ఎక్కువగానే
ekkuvasEpu	ఎక్కువసేపు
eksCEMjIla	ఎక్స్ఛేంజీల
eksCEMjIllO	ఎక్స్ఛేంజీల్లో
elA	ఎలా
elAMTi	ఎలాంటి
elAgO	ఎలాగో
elaMTi	ఎలంటి
ellajIvulakU	ఎల్లజీవులకూ
ellamma	ఎల్లమ్మ
ellammagA	ఎల్లమ్మగా
ellammatalli	ఎల్లమ్మతల్లి
ellammatallini	ఎల్లమ్మతల్లిని
elugetti	ఎలుగెత్తి
emukala	ఎముకల
emukalu	ఎముకలు
enimidELla	ఎనిమిదేళ్ల
enimidi	ఎనిమిది
ennO	ఎన్నో
ennOsArlu	ఎన్నోసార్లు
ennaDU	ఎన్నడూ
ennennO	ఎన్నెన్నో
enni	ఎన్ని
eppuDO	ఎప్పుడో
eppuDU	ఎప్పుడూ
eppuDainA	ఎప్పుడైనా
eppuDu	ఎప్పుడు
erupu	ఎరుపు
es	ఎస్
ettayina	ఎత్తయిన
ettuMDE	ఎత్తుండే
ettuna	ఎత్తున
ettunuMci	ఎత్తునుంచి
evarU	ఎవరూ
evaraM	ఎవరం
evarainA	ఎవరైనా
evarainAgAnI	ఎవరైనాగానీ
evaridainA	ఎవరిదైనా
evarikI	ఎవరికీ
evarikainA	ఎవరికైనా
evariki	ఎవరికి
evarikishTaM	ఎవరికిష్టం
evaru	ఎవరు
evvarikI	ఎవ్వరికీ
eyiDs	ఎయిడ్స్
eyims	ఎయిమ్స్
gA	గా
gADha	గాఢ
gADhaMgA	గాఢంగా
gADhamaina	గాఢమైన
gADhanidra	గాఢనిద్ర
gADhata	గాఢత
gADi	గాడి
gADilO	గాడిలో
gAMgEyarAya	గాంగేయరాయ
gAMgEyulu	గాంగేయులు
gAbharA	గాభరా
gAjulU	గాజులూ
gAli	గాలి
gAnI	గానీ
gAthE	గాథే
gAtha	గాథ
gAthallO	గాథల్లో
gAthatO	గాథతో
gAyapaDitE	గాయపడితే
gODala	గోడల
gODalapai	గోడలపై
gOdAvarI	గోదావరీ
gOdAvari	గోదావరి
gOdAvarini	గోదావరిని
gOlkoMDa	గోల్కొండ
gOpurAlu	గోపురాలు
gOpura	గోపుర
gOviMdarAjasvAmi	గోవిందరాజస్వామి
gRhiNi	గృహిణి
gUDA	గూడా
gaDapaDAniki	గడపడానికి
gaDicipOvaTAniki	గడిచిపోవటానికి
gaDipE	గడిపే
gaDipElA	గడిపేలా
gaDipitE	గడిపితే
gaDuputAru	గడుపుతారు
gaDustuMdi	గడుస్తుంది
gaMDabhEruMDa	గండభేరుండ
gaMDabhEruMDadEva	గండభేరుండదేవ
gaMTa	గంట
gaMTala	గంటల
gaMTalaku	గంటలకు
gaMTalapATu	గంటలపాటు
gaMTalu	గంటలు
gaMdaragOLAlaku	గందరగోళాలకు
gaMdaragOLAluMDavu	గందరగోళాలుండవు
gaMdaragOLAniki	గందరగోళానికి
gaMdaragOLaM	గందరగోళం
gaMdaragOLaMlO	గందరగోళంలో
gaNapati	గణపతి
gaTTipaDutuMDoccu	గట్టిపడుతుండొచ్చు
gaccu	గచ్చు
gaditO	గదితో
gadullO	గదుల్లో
gajapatulu	గజపతులు
gajji	గజ్జి
galagalA	గలగలా
galavArE	గలవారే
galavAriki	గలవారికి
galavAru	గలవారు
gamanAnni	గమనాన్ని
gamanArhaM	గమనార్హం
gamaniMcAli	గమనించాలి
gamaniMcArAme	గమనించారామె
gamaniMcAru	గమనించారు
gamanistE	గమనిస్తే
gamanistuMTAru	గమనిస్తుంటారు
gamyaM	గమ్యం
garbhAlaMTE	గర్భాలంటే
garbhAlaMyaMlOki	గర్భాలంయంలోకి
garbhAlayAniki	గర్భాలయానికి
garbhanirOdhaM	గర్భనిరోధం
garbhanirOdhaka	గర్భనిరోధక
garbhiNulu	గర్భిణులు
garishThaM	గరిష్ఠం
garishThaMgA	గరిష్ఠంగా
garuDOtsavaM	గరుడోత్సవం
garuDOtsavaMtO	గరుడోత్సవంతో
gatAnikI	గతానికీ
gataM	గతం
gaurI	గౌరీ
gauravaM	గౌరవం
gauravapradamaina	గౌరవప్రదమైన
gauraviMcaTaM	గౌరవించటం
gautama	గౌతమ
gaya	గయ
gelici	గెలిచి
ghOra	ఘోర
ghOshiMcE	ఘోషించే
ghaDiyallO	ఘడియల్లో
ghaDiyalu	ఘడియలు
ghaMTasAla	ఘంటసాల
ghaTTamaina	ఘట్టమైన
ghanaMgA	ఘనంగా
gharshaNaku	ఘర్షణకు
giMjalu	గింజలు
goDrALla	గొడ్రాళ్ల
goppa	గొప్ప
grA	గ్రా
grAmAla	గ్రామాల
grAmAllO	గ్రామాల్లో
grAmAnikI	గ్రామానికీ
grAmAniki	గ్రామానికి
grAmINula	గ్రామీణుల
grAma	గ్రామ
grAmaMlO	గ్రామంలో
grAmaMlOnU	గ్రామంలోనూ
grIku	గ్రీకు
grUp	గ్రూప్
graha	గ్రహ
grahiMcAru	గ్రహించారు
grahiMcE	గ్రహించే
grahiMcEMduku	గ్రహించేందుకు
grahiMcukOvaTaMlOnU	గ్రహించుకోవటంలోనూ
guDDinammakAllOMcI	గుడ్డినమ్మకాల్లోంచీ
guDi	గుడి
guLlalO	గుళ్లలో
guMDe	గుండె
guMDejabbu	గుండెజబ్బు
guMDenu	గుండెను
guMDepOTu	గుండెపోటు
guNaM	గుణం
guNavaMtuDE	గుణవంతుడే
guhalO	గుహలో
gummaMlO	గుమ్మంలో
guptA	గుప్తా
guraina	గురైన
guravutunnArA	గురవుతున్నారా
gurayyADaTa	గురయ్యాడట
gurayyADu	గురయ్యాడు
guriMcE	గురించే
guriMcI	గురించీ
guriMci	గురించి
gurrAlU	గుర్రాలూ
gurraM	గుర్రం
gurraMpai	గుర్రంపై
gurterigi	గుర్తెరిగి
gurtiMcAli	గుర్తించాలి
gurtiMcAru	గుర్తించారు
gurtiMcaM	గుర్తించం
gurtiMcaTamE	గుర్తించటమే
gurtiMcalEkapOvaccu	గుర్తించలేకపోవచ్చు
gurtiMci	గుర్తించి
gurtiMciMdI	గుర్తించిందీ
gurtiMpu	గుర్తింపు
gurtiMputO	గుర్తింపుతో
gurtistE	గుర్తిస్తే
gurtistU	గుర్తిస్తూ
gurtistuMdi	గుర్తిస్తుంది
gurtukostAyi	గుర్తుకొస్తాయి
guruvArAlu	గురువారాలు
hAjaravutAru	హాజరవుతారు
hAjaravvAlsi	హాజరవ్వాల్సి
hAjarukAvAlsi	హాజరుకావాల్సి
hAlu	హాలు
hAnicEyani	హానిచేయని
hArmOn	హార్మోన్
hArmOnE	హార్మోనే
hArmOnlE	హార్మోన్లే
hArmOnla	హార్మోన్ల
hArmOnlu	హార్మోన్లు
hArvarD	హార్వర్డ్
hAthIrAMjI	హాథీరాంజీ
hAyigA	హాయిగా
hEmaM	హేమం
hEmalAMba	హేమలాంబ
hOdA	హోదా
hRdayESvarini	హృదయేశ్వరిని
hRdayakshEtraMgA	హృదయక్షేత్రంగా
haDAvuDigA	హడావుడిగా
haMpI	హంపీ
haibIpI	హైబీపీ
haidarAbAd	హైదరాబాద్
hakku	హక్కు
haraharamahAdEva	హరహరమహాదేవ
hariMcAlani	హరించాలని
hariMcE	హరించే
hariMcukupOyikUlabaDipOtuMTAM	హరించుకుపోయికూలబడిపోతుంటాం
hariMpajEstADani	హరింపజేస్తాడని
harihara	హరిహర
hariharuliddarU	హరిహరులిద్దరూ
haristunnADani	హరిస్తున్నాడని
hastaprayOgaM	హస్తప్రయోగం
hattukOvaTaM	హత్తుకోవటం
havissunu	హవిస్సును
hayAMlO	హయాంలో
hec	హెచ్
heccarikallO	హెచ్చరికల్లో
heccaristunnAru	హెచ్చరిస్తున్నారు
hiraNyakaSipuDini	హిరణ్యకశిపుడిని
hushArugA	హుషారుగా
i	ఇ
iLlalO	ఇళ్లలో
iLlanu	ఇళ్లను
iMDOr	ఇండోర్
iMDiyA	ఇండియా
iMDiyAgA	ఇండియాగా
iMDiyAlO	ఇండియాలో
iMTarneT	ఇంటర్నెట్
iMTi	ఇంటి
iMTiki	ఇంటికి
iMTikoccAka	ఇంటికొచ్చాక
iMTikocciMdi	ఇంటికొచ్చింది
iMTlO	ఇంట్లో
iMTlOkeLli	ఇంట్లోకెళ్లి
iMTlOnO	ఇంట్లోనో
iMTlOnU	ఇంట్లోనూ
iMduku	ఇందుకు
iMdulO	ఇందులో
iMkA	ఇంకా
iMkO	ఇంకో
iMpIriyal	ఇంపీరియల్
iMtE	ఇంతే
iMtaTi	ఇంతటి
iMtakannA	ఇంతకన్నా
iMtalO	ఇంతలో
iTIvalE	ఇటీవలే
iTIvali	ఇటీవలి
iTu	ఇటు
iTuvaMTi	ఇటువంటి
ibbaMdigA	ఇబ్బందిగా
ibbaMdikaraMgA	ఇబ్బందికరంగా
ibbaMdipeDutunnAnanna	ఇబ్బందిపెడుతున్నానన్న
ibbaMdipeTTE	ఇబ్బందిపెట్టే
ibbaMdullO	ఇబ్బందుల్లో
iccAru	ఇచ్చారు
iccE	ఇచ్చే
iccinaTlu	ఇచ్చినట్లు
idE	ఇదే
idEM	ఇదేం
idEdO	ఇదేదో
idEmI	ఇదేమీ
idEmiTani	ఇదేమిటని
idEnaMTAru	ఇదేనంటారు
idI	ఇదీ
idO	ఇదో
idaMtA	ఇదంతా
iddaraM	ఇద్దరం
iddarilOnU	ఇద్దరిలోనూ
iddarinI	ఇద్దరినీ
iddaru	ఇద్దరు
ideMtO	ఇదెంతో
idi	ఇది
idivaralOnE	ఇదివరలోనే
idoka	ఇదొక
ika	ఇక
ikkaDE	ఇక్కడే
ikkaDa	ఇక్కడ
ikkaDaku	ఇక్కడకు
ikkaDi	ఇక్కడి
ikkaDiki	ఇక్కడికి
ilA	ఇలా
ilAMTi	ఇలాంటి
ilAMTicOTla	ఇలాంటిచోట్ల
ilAMTivAriki	ఇలాంటివారికి
ilAMTivannI	ఇలాంటివన్నీ
ilAgE	ఇలాగే
inisTiTyUT	ఇనిస్టిట్యూట్
inni	ఇన్ని
inumunu	ఇనుమును
ippaTi	ఇప్పటి
ippaTikI	ఇప్పటికీ
ippiMci	ఇప్పించి
ippistunnAru	ఇప్పిస్తున్నారు
ippuDu	ఇప్పుడు
ippuDuMdi	ఇప్పుడుంది
ipuDu	ఇపుడు
iravai	ఇరవై
irikiMcaTaM	ఇరికించటం
iruvurikI	ఇరువురికీ
iruvurilOnU	ఇరువురిలోనూ
ishTAyishTAlanu	ఇష్టాయిష్టాలను
ishTaM	ఇష్టం
ishTaMgA	ఇష్టంగా
ishTamaTa	ఇష్టమట
ishTapaDitE	ఇష్టపడితే
istAnu	ఇస్తాను
istAru	ఇస్తారు
istE	ఇస్తే
istunnAru	ఇస్తున్నారు
istunnAyi	ఇస్తున్నాయి
isuka	ఇసుక
itara	ఇతర
itaratrA	ఇతరత్రా
itarula	ఇతరుల
ivannI	ఇవన్నీ
iveMduku	ఇవెందుకు
ivi	ఇవి
ivikAka	ఇవికాక
ivvAlsina	ఇవ్వాల్సిన
ivvAlsinaMtaTi	ఇవ్వాల్సినంతటి
ivvaDAniki	ఇవ్వడానికి
ivvaDAnni	ఇవ్వడాన్ని
ivvaMDi	ఇవ్వండి
ivvaTAniki	ఇవ్వటానికి
ivvaTaM	ఇవ్వటం
ivvaccu	ఇవ్వచ్చు
ivvalEM	ఇవ్వలేం
ivvalEkapOtunnAnA	ఇవ్వలేకపోతున్నానా
ivvalEru	ఇవ్వలేరు
ivvoccu	ఇవ్వొచ్చు
ivvoccugAnI	ఇవ్వొచ్చుగానీ
jAgrattagA	జాగ్రత్తగా
jAgrattala	జాగ్రత్తల
jAgrattalu	జాగ్రత్తలు
jAnsan	జాన్సన్
jAnu	జాను
jArI	జారీ
jArIcEsi	జారీచేసి
jAri	జారి
jAripOtuMTAru	జారిపోతుంటారు
jAripOyiMdi	జారిపోయింది
jAvagAripOtuMTAru	జావగారిపోతుంటారు
jEbIes	జేబీఎస్
jI	జీ
jItabhatyAlaku	జీతభత్యాలకు
jIva	జీవ
jIvakriyala	జీవక్రియల
jIvakriyalannI	జీవక్రియలన్నీ
jIvana	జీవన
jIvanaM	జీవనం
jIvanaSaili	జీవనశైలి
jIvanaSaililO	జీవనశైలిలో
jIvikainA	జీవికైనా
jIvistunnAmanna	జీవిస్తున్నామన్న
jIvitAMtaM	జీవితాంతం
jIvitAllO	జీవితాల్లో
jIvitAnnE	జీవితాన్నే
jIvitAnni	జీవితాన్ని
jIvita	జీవిత
jIvitaM	జీవితం
jIvitaMlO	జీవితంలో
jIvitaMlOnU	జీవితంలోనూ
jIvitaMlOni	జీవితంలోని
jIyar	జీయర్
jJApakaSakti	జ్ఞాపకశక్తి
jOkyaM	జోక్యం
jOliki	జోలికి
jaDaMgA	జడంగా
jaMTA	జంటా
jaMtujAlaM	జంతుజాలం
jaMtuvula	జంతువుల
jaMtuvulanu	జంతువులను
jaTAjUTaM	జటాజూటం
jabbu	జబ్బు
jabbula	జబ్బుల
jabbulu	జబ్బులు
jabbutO	జబ్బుతో
jagattulO	జగత్తులో
jaipUr	జైపూర్
jalAlatO	జలాలతో
jalAlu	జలాలు
jalAnnE	జలాన్నే
jaladhAra	జలధార
jaladurgagA	జలదుర్గగా
jalapAta	జలపాత
jalubu	జలుబు
jamIMdArulu	జమీందారులు
jamiMdArulaina	జమిందారులైన
janAbhA	జనాభా
janAnni	జనాన్ని
janaM	జనం
jananAMgAla	జననాంగాల
jananAMgAlanu	జననాంగాలను
jananAMga	జననాంగ
jananAvayavAlu	జననావయవాలు
japAn	జపాన్
jaragabOyE	జరగబోయే
jaragakapOvaccu	జరగకపోవచ్చు
jarapagA	జరపగా
jarigE	జరిగే
jarigi	జరిగి
jarigiMdO	జరిగిందో
jarigiMdani	జరిగిందని
jarigiMdi	జరిగింది
jarigipOyiMdani	జరిగిపోయిందని
jarigitE	జరిగితే
jarimAnA	జరిమానా
jarugutAyi	జరుగుతాయి
jarugutuMDE	జరుగుతుండే
jarugutuMDEvi	జరుగుతుండేవి
jarugutuMTAyi	జరుగుతుంటాయి
jarugutuMdO	జరుగుతుందో
jarugutuMdi	జరుగుతుంది
jarugutunnAyi	జరుగుతున్నాయి
jarugutunna	జరుగుతున్న
jarupukoMTOMdi	జరుపుకొంటోంది
jarupukuMTAru	జరుపుకుంటారు
jaruputAru	జరుపుతారు
jata	జత
jayajayadhvAnAla	జయజయధ్వానాల
jillA	జిల్లా
jillAlOni	జిల్లాలోని
jillAla	జిల్లాల
jivvumannAy	జివ్వుమన్నాయ్
jvAlA	జ్వాలా
jyOtisha	జ్యోతిష
kAMcIpurAniki	కాంచీపురానికి
kAMksha	కాంక్ష
kASIgA	కాశీగా
kASIlO	కాశీలో
kASIviSvESvaruDu	కాశీవిశ్వేశ్వరుడు
kASi	కాశి
kASyAM	కాశ్యాం
kATEj	కాటేజ్
kATEjIlu	కాటేజీలు
kAbOtunnAyi	కాబోతున్నాయి
kAbaTTE	కాబట్టే
kAbaTTi	కాబట్టి
kAdanI	కాదనీ
kAdanaDAniki	కాదనడానికి
kAdanalEM	కాదనలేం
kAdani	కాదని
kAdu	కాదు
kAgA	కాగా
kAgAnE	కాగానే
kAkapOtE	కాకపోతే
kAkapOvaccu	కాకపోవచ్చు
kAkatIyulu	కాకతీయులు
kAkinADa	కాకినాడ
kAkinADaku	కాకినాడకు
kAkinADala	కాకినాడల
kAkuLESvaruDigA	కాకుళేశ్వరుడిగా
kAkuLamani	కాకుళమని
kAkuMDA	కాకుండా
kAlEdu	కాలేదు
kAlEjIki	కాలేజీకి
kAla	కాల
kAlaM	కాలం
kAlaMlO	కాలంలో
kAlaMlOnE	కాలంలోనే
kAlabhairavuDu	కాలభైరవుడు
kAlagamanaMlO	కాలగమనంలో
kAlakRtyAlu	కాలకృత్యాలు
kAlakramENA	కాలక్రమేణా
kAlakramaMlO	కాలక్రమంలో
kAlasarpadOsha	కాలసర్పదోష
kAli	కాలి
kAlinaDakana	కాలినడకన
kAm	కామ్
kAmAkshIdEvi	కామాక్షీదేవి
kAmars	కామర్స్
kAmasUtra	కామసూత్ర
kAmasUtramE	కామసూత్రమే
kAmitArthAlanu	కామితార్థాలను
kAnI	కానీ
kAnarAka	కానరాక
kAniccE	కానిచ్చే
kAnicceyyakuMDA	కానిచ్చెయ్యకుండా
kAnukalni	కానుకల్ని
kApADukOvaTaM	కాపాడుకోవటం
kApADukOvaTamE	కాపాడుకోవటమే
kApADukOvaccani	కాపాడుకోవచ్చని
kApADukuMTAru	కాపాడుకుంటారు
kApADutuMdani	కాపాడుతుందని
kApADutuMdi	కాపాడుతుంది
kApurAniki	కాపురానికి
kArDu	కార్డు
kArTUnlu	కార్టూన్లు
kAraNAlEvI	కారణాలేవీ
kAraNAlu	కారణాలు
kAraNaM	కారణం
kAraNaMgA	కారణంగా
kAraNamayyE	కారణమయ్యే
kArakuDE	కారకుడే
kArlalO	కార్లలో
kArporEshan	కార్పొరేషన్
kArtIka	కార్తీక
kArtIkaMlO	కార్తీకంలో
kArtIkamAsaM	కార్తీకమాసం
kAruNya	కారుణ్య
kAryAlayaMlO	కార్యాలయంలో
kAryaMgA	కార్యంగా
kAryakalApAlaku	కార్యకలాపాలకు
kAryakalApAlu	కార్యకలాపాలు
kAryakramAla	కార్యక్రమాల
kAryakramAniki	కార్యక్రమానికి
kAryakramaM	కార్యక్రమం
kAsEpayyAka	కాసేపయ్యాక
kAstA	కాస్తా
kAsta	కాస్త
kAstaMta	కాస్తంత
kAstaMtainA	కాస్తంతైనా
kAstamuMdu	కాస్తముందు
kAvAlaMTE	కావాలంటే
kAvAlanE	కావాలనే
kAvAli	కావాలి
kAvAlsiMdi	కావాల్సింది
kAvaDAniki	కావడానికి
kAvaDaM	కావడం
kAvaDaMtO	కావడంతో
kAvaTAniki	కావటానికి
kAvaTamannadi	కావటమన్నది
kAvaccu	కావచ్చు
kAvanI	కావనీ
kAvyAnni	కావ్యాన్ని
kAvyAvishkaraNa	కావ్యావిష్కరణ
kAvyaMlO	కావ్యంలో
kEMdrAlu	కేంద్రాలు
kEMdrIkariMcAli	కేంద్రీకరించాలి
kEMdraM	కేంద్రం
kEMdraMgA	కేంద్రంగా
kEkEsiMdi	కేకేసింది
kEsullO	కేసుల్లో
kEvalaM	కేవలం
kIlaka	కీలక
kIlakaM	కీలకం
kIlakaMgA	కీలకంగా
kIlakamE	కీలకమే
kIlakamaina	కీలకమైన
kIlakamainadi	కీలకమైనది
kIlakamainavI	కీలకమైనవీ
kIrtiMcAru	కీర్తించారు
kIrtinoMdADani	కీర్తినొందాడని
kODiMg	కోడింగ్
kODiguDDu	కోడిగుడ్డు
kONaM	కోణం
kOTak	కోటక్
kOTipalli	కోటిపల్లి
kOTla	కోట్ల
kOTlu	కోట్లు
kOdaMDarAmanna	కోదండరామన్న
kOdaMDarAmasvAmivAri	కోదండరామస్వామివారి
kOlaMka	కోలంక
kOlpOtuMTuMdi	కోల్పోతుంటుంది
kOlpOyina	కోల్పోయిన
kOlukunna	కోలుకున్న
kOnETi	కోనేటి
kOr	కోర్
kOrAraTa	కోరారట
kOrika	కోరిక
kOrikanu	కోరికను
kOrikapai	కోరికపై
kOrkelu	కోర్కెలు
kOrn	కోర్న్
kOrukOkakapOvaccu	కోరుకోకకపోవచ్చు
kOrukOvaccu	కోరుకోవచ్చు
kOrukunna	కోరుకున్న
kOrumilli	కోరుమిల్లి
kOsaM	కోసం
kOsamE	కోసమే
kRshNAjillA	కృష్ణాజిల్లా
kRshNAjillAlOni	కృష్ణాజిల్లాలోని
kRshNAnadilO	కృష్ణానదిలో
kRshNAtIrAnunna	కృష్ణాతీరానున్న
kRshNamUrti	కృష్ణమూర్తి
kRtayugaMlO	కృతయుగంలో
kRtrimaMgA	కృత్రిమంగా
kUDA	కూడా
kUDadu	కూడదు
kUDina	కూడిన
kUconi	కూచొని
kUcunE	కూచునే
kUcunnappuDu	కూచున్నప్పుడు
kUrcObeTTA	కూర్చోబెట్టా
kUrcObeTTE	కూర్చోబెట్టే
kUrcObeTTEyaDaM	కూర్చోబెట్టేయడం
kUrcunE	కూర్చునే
kUrcunnA	కూర్చున్నా
kUrcunnAM	కూర్చున్నాం
kUrukOkUDadu	కూరుకోకూడదు
kUrukuMTAru	కూరుకుంటారు
kUrukuni	కూరుకుని
kUrukupOlEM	కూరుకుపోలేం
kUrukupOtunna	కూరుకుపోతున్న
kUtuLliddarU	కూతుళ్లిద్దరూ
kUturiki	కూతురికి
kaDupu	కడుపు
kaDupulOki	కడుపులోకి
kaDupunaku	కడుపునకు
kaDutunnAyi	కడుతున్నాయి
kaLASAlalO	కళాశాలలో
kaLAkArulu	కళాకారులు
kaLakaLalADutuMTAyi	కళకళలాడుతుంటాయి
kaLlArA	కళ్లారా
kaLlU	కళ్లూ
kaMDarAlE	కండరాలే
kaMDarAla	కండరాల
kaMDarAlanu	కండరాలను
kaMDarAlu	కండరాలు
kaMDara	కండర
kaMTE	కంటే
kaMTa	కంట
kaMTiki	కంటికి
kaMgArupaDaru	కంగారుపడరు
kaMpenIlO	కంపెనీలో
kaMpenIlakU	కంపెనీలకూ
kaMpenIlaku	కంపెనీలకు
kaNAlaku	కణాలకు
kaNaM	కణం
kaNajAlaM	కణజాలం
kaNiti	కణితి
kaSyapa	కశ్యప
kaTTaDi	కట్టడి
kaTTabATlanu	కట్టబాట్లను
kaTTabeTTEMduku	కట్టబెట్టేందుకు
kaTTiMcukunnappuDu	కట్టించుకున్నప్పుడు
kaTTu	కట్టు
kaTTubATlU	కట్టుబాట్లూ
kaThinaMgA	కఠినంగా
kaThinamaina	కఠినమైన
kaTika	కటిక
kaTnaM	కట్నం
kaTnaMgA	కట్నంగా
kaburu	కబురు
kaccitaMgA	కచ్చితంగా
kaccitamaina	కచ్చితమైన
kadA	కదా
kadalaTaM	కదలటం
kadalika	కదలిక
kadalikalu	కదలికలు
kadallEdu	కదల్లేదు
kadiliMcAlsi	కదిలించాల్సి
kadilinA	కదిలినా
kadulutuMTAru	కదులుతుంటారు
kadulutuMdi	కదులుతుంది
kaiMkaryAla	కైంకర్యాల
kailAsa	కైలాస
kailAsagirigAnE	కైలాసగిరిగానే
kailAsapati	కైలాసపతి
kaivalyaM	కైవల్యం
kalagaTAniki	కలగటానికి
kalagaTaM	కలగటం
kalagajEstAyi	కలగజేస్తాయి
kalakattAgA	కలకత్తాగా
kalalO	కలలో
kalala	కలల
kalavaDaM	కలవడం
kalavakuMDA	కలవకుండా
kalavarapeDutuMTAyi	కలవరపెడుతుంటాయి
kalayika	కలయిక
kalekTar	కలెక్టర్
kaligiMdanI	కలిగిందనీ
kaligistAyani	కలిగిస్తాయని
kaliguMDaTamE	కలిగుండటమే
kalipEsukunna	కలిపేసుకున్న
kalipi	కలిపి
kalisE	కలిసే
kalisi	కలిసి
kalisimelisi	కలిసిమెలిసి
kalistE	కలిస్తే
kaliyugAraMbhaMlO	కలియుగారంభంలో
kaliyuga	కలియుగ
kaliyugaMlO	కలియుగంలో
kallOlAniki	కల్లోలానికి
kallOlaM	కల్లోలం
kalpiMcE	కల్పించే
kalpiMcaDaMtO	కల్పించడంతో
kalpiMcanunnAru	కల్పించనున్నారు
kalpiMciMdi	కల్పించింది
kalpiMcina	కల్పించిన
kalpistAmani	కల్పిస్తామని
kalpistAru	కల్పిస్తారు
kalpistOMdi	కల్పిస్తోంది
kalpistU	కల్పిస్తూ
kalpistuMdi	కల్పిస్తుంది
kalugutAyi	కలుగుతాయి
kalugutuMdanI	కలుగుతుందనీ
kalugutuMdi	కలుగుతుంది
kalupukuMTE	కలుపుకుంటే
kalusukOvaDAlu	కలుసుకోవడాలు
kalyANAlu	కల్యాణాలు
kalyANAniki	కల్యాణానికి
kalyANOtsavAlu	కల్యాణోత్సవాలు
kalyANOtsavAniki	కల్యాణోత్సవానికి
kalyANOtsavAnni	కల్యాణోత్సవాన్ని
kalyANOtsavaM	కల్యాణోత్సవం
kalyANaM	కల్యాణం
kalyANakaTTa	కల్యాణకట్ట
kanAlA	కనాలా
kanEsi	కనేసి
kanIsa	కనీస
kanIsaM	కనీసం
kanabaDE	కనబడే
kanabaDEvi	కనబడేవి
kanabaDutOMdani	కనబడుతోందని
kanabaDutOMdi	కనబడుతోంది
kanabaDutuMTAyannadi	కనబడుతుంటాయన్నది
kanabaDutuMTE	కనబడుతుంటే
kanabaDutuMdi	కనబడుతుంది
kanabaDutunnAyi	కనబడుతున్నాయి
kanabarustUnE	కనబరుస్తూనే
kanaka	కనక
kanakasabhApati	కనకసభాపతి
kanipeTTi	కనిపెట్టి
kanipiMcalEdaTa	కనిపించలేదట
kanipiMci	కనిపించి
kanipistAyi	కనిపిస్తాయి
kanipistuMdi	కనిపిస్తుంది
kanishThaM	కనిష్ఠం
kannA	కన్నా
kannILlu	కన్నీళ్లు
kanuka	కనుక
kanuma	కనుమ
kapAla	కపాల
kapilESvara	కపిలేశ్వర
kapilESvaruDu	కపిలేశ్వరుడు
kapila	కపిల
kapilamuni	కపిలముని
kapilatIrthaM	కపిలతీర్థం
kapilatIrthaMlO	కపిలతీర్థంలో
kappullO	కప్పుల్లో
karaNi	కరణి
kareMTu	కరెంటు
karmasAkshi	కర్మసాక్షి
karnUlu	కర్నూలు
karuvaiMdi	కరువైంది
kashTAlu	కష్టాలు
kashTaM	కష్టం
kashTaMgA	కష్టంగా
kashTamayyiMdani	కష్టమయ్యిందని
kashTapaDakuMDA	కష్టపడకుండా
kashTapaDi	కష్టపడి
kathalu	కథలు
kathalugA	కథలుగా
kathanaM	కథనం
kauMTarla	కౌంటర్ల
kaugiliMcukOvaTaM	కౌగిలించుకోవటం
kaunseliMg	కౌన్సెలింగ్
kausta	కౌస్త
kavar	కవర్
kavi	కవి
kavita	కవిత
khALI	ఖాళీ
khaDgamRgaM	ఖడ్గమృగం
khaMDAlu	ఖండాలు
khaMDaM	ఖండం
kharAraiMdi	ఖరారైంది
kharIdaina	ఖరీదైన
kharIdu	ఖరీదు
kharcu	ఖర్చు
khyAti	ఖ్యాతి
ki	కి
kiDAMbi	కిడాంబి
kiDnI	కిడ్నీ
kiDnIlO	కిడ్నీలో
kiMcana	కించన
kiMda	కింద
kiMdi	కింది
kiMdiki	కిందికి
kiMdivaipu	కిందివైపు
kiMdugA	కిందుగా
kiTikIlu	కిటికీలు
kilOmITarlU	కిలోమీటర్లూ
kilOmITarla	కిలోమీటర్ల
kilOmITarlu	కిలోమీటర్లు
kipaigA	కిపైగా
kiraNAlu	కిరణాలు
klinik	క్లినిక్
koDAli	కొడాలి
koMDa	కొండ
koMDaMta	కొండంత
koMDalaku	కొండలకు
koMDalamIdi	కొండలమీది
koMDalu	కొండలు
koMDapai	కొండపై
koMDapaiki	కొండపైకి
koMDapainE	కొండపైనే
koMDavITi	కొండవీటి
koMceM	కొంచెం
koMdari	కొందరి
koMdariki	కొందరికి
koMdaru	కొందరు
koMpalu	కొంపలు
koMtO	కొంతో
koMta	కొంత
koMtakAlAnikE	కొంతకాలానికే
koTTAra	కొట్టార
koTTukupOyE	కొట్టుకుపోయే
koTTumiTTADutU	కొట్టుమిట్టాడుతూ
koddI	కొద్దీ
koddi	కొద్ది
koddigA	కొద్దిగా
koddimottaMlOnE	కొద్దిమొత్తంలోనే
koddirOjulakE	కొద్దిరోజులకే
koddisEpaTi	కొద్దిసేపటి
koddisEpu	కొద్దిసేపు
kolamAnamEM	కొలమానమేం
kolavaTaM	కొలవటం
kolesTrAl	కొలెస్ట్రాల్
kolistE	కొలిస్తే
koluvai	కొలువై
koluvaina	కొలువైన
koluvainadi	కొలువైనది
koluvayyADu	కొలువయ్యాడు
koluvudIrADanI	కొలువుదీరాడనీ
koluvudIri	కొలువుదీరి
koluvudIrina	కొలువుదీరిన
komarArAma	కొమరారామ
kommulU	కొమ్ములూ
konE	కొనే
kona	కొన
konasAgElA	కొనసాగేలా
konasAgiMcAli	కొనసాగించాలి
konasAgiMcagalugutAru	కొనసాగించగలుగుతారు
konasAgiMdi	కొనసాగింది
konasAgutAyi	కొనసాగుతాయి
konasAgutUnE	కొనసాగుతూనే
konasAgutuMDaTaM	కొనసాగుతుండటం
koniccEyaMDi	కొనిచ్చేయండి
koniyADADu	కొనియాడాడు
konnALlakE	కొన్నాళ్లకే
konnALlaki	కొన్నాళ్లకి
konnALlaku	కొన్నాళ్లకు
konnALlu	కొన్నాళ్లు
konnELla	కొన్నేళ్ల
konni	కొన్ని
konnikonni	కొన్నికొన్ని
konnirOjulaku	కొన్నిరోజులకు
konnisArlu	కొన్నిసార్లు
konugOLla	కొనుగోళ్ల
konugOlu	కొనుగోలు
konugOlunu	కొనుగోలును
konukkOlEru	కొనుక్కోలేరు
koragAkuMDA	కొరగాకుండా
korata	కొరత
koratapai	కొరతపై
koravaDaTaM	కొరవడటం
koravaDaTaMtO	కొరవడటంతో
koravaDi	కొరవడి
koravaDoccu	కొరవడొచ్చు
koravaDutuMdi	కొరవడుతుంది
kotta	కొత్త
kottagA	కొత్తగా
kottalO	కొత్తలో
krIDAbhirAmaMlO	క్రీడాభిరామంలో
krIstuSakaM	క్రీస్తుశకం
krIstupUrvaM	క్రీస్తుపూర్వం
krUramRgAlni	క్రూరమృగాల్ని
kramEpI	క్రమేపీ
kramaM	క్రమం
kramaMlO	క్రమంలో
kramapaddhatilO	క్రమపద్ధతిలో
kratuvulu	క్రతువులు
kritaM	క్రితం
kriyalO	క్రియలో
kshEtaM	క్షేతం
kshEtrAllO	క్షేత్రాల్లో
kshEtrAllOnU	క్షేత్రాల్లోనూ
kshEtrAniki	క్షేత్రానికి
kshEtrAnni	క్షేత్రాన్ని
kshEtra	క్షేత్ర
kshEtraM	క్షేత్రం
kshEtraMgA	క్షేత్రంగా
kshEtraMlO	క్షేత్రంలో
kshEtragAtha	క్షేత్రగాథ
kshEtramaina	క్షేత్రమైన
kshEtrapAlakuDaina	క్షేత్రపాలకుడైన
kshEtrarAjaM	క్షేత్రరాజం
kshEtrarAjaMgA	క్షేత్రరాజంగా
kshINata	క్షీణత
kshIrArAmESvaruDigA	క్షీరారామేశ్వరుడిగా
kshaNAlainA	క్షణాలైనా
ku	కు
kuMgadIstOMdi	కుంగదీస్తోంది
kuMgadIstuMdi	కుంగదీస్తుంది
kuMgubATu	కుంగుబాటు
kuTuMbAla	కుటుంబాల
kuTuMbAlaku	కుటుంబాలకు
kuTuMbAlavArE	కుటుంబాలవారే
kuTuMbAlu	కుటుంబాలు
kuTuMba	కుటుంబ
kuTuMbaM	కుటుంబం
kuTuMbaMlO	కుటుంబంలో
kuciMcukupOyi	కుచించుకుపోయి
kudaradu	కుదరదు
kugrAmaM	కుగ్రామం
kumAruDaina	కుమారుడైన
kumilipOtUnE	కుమిలిపోతూనే
kurcI	కుర్చీ
kuripistuMdA	కురిపిస్తుందా
kurrADitO	కుర్రాడితో
kutUhalaM	కుతూహలం
kutUhalaMtO	కుతూహలంతో
kyAb	క్యాబ్
kyAlshiyaM	క్యాల్షియం
kyAnsar	క్యాన్సర్
kyUlain	క్యూలైన్
kyUr	క్యూర్
lADji	లాడ్జి
lADjila	లాడ్జిల
lAMTi	లాంటి
lAbhAlEmiTi	లాభాలేమిటి
lAbhAlunnAyi	లాభాలున్నాయి
lAbhaM	లాభం
lAbhaMlEkapOyiMdi	లాభంలేకపోయింది
lAbhasATi	లాభసాటి
lAgA	లాగా
lAkkuMTU	లాక్కుంటూ
lAs	లాస్
lAvugA	లావుగా
lEcA	లేచా
lEci	లేచి
lEdA	లేదా
lEdEMTani	లేదేంటని
lEdO	లేదో
lEdaMTE	లేదంటే
lEdaMTunnAru	లేదంటున్నారు
lEdanI	లేదనీ
lEdani	లేదని
lEdu	లేదు
lEhyAllAMTivi	లేహ్యాల్లాంటివి
lEka	లేక
lEkapOtE	లేకపోతే
lEkapOvaDaMtO	లేకపోవడంతో
lEkapOvaTAnnE	లేకపోవటాన్నే
lEkapOvaTaM	లేకపోవటం
lEkapOvaTaMtO	లేకపోవటంతో
lEkapOyinA	లేకపోయినా
lEkuMDA	లేకుండా
lEkunnA	లేకున్నా
lEnE	లేనే
lEni	లేని
lEnipOni	లేనిపోని
lEnivAri	లేనివారి
lEnivAru	లేనివారు
lEnivI	లేనివీ
lEstU	లేస్తూ
lEvAli	లేవాలి
lEvaTaM	లేవటం
lEvani	లేవని
lEvu	లేవు
lO	లో
lOdustula	లోదుస్తుల
lOdustulu	లోదుస్తులు
lOkaM	లోకం
lOkakalyANArthaM	లోకకల్యాణార్థం
lOkakalyANa	లోకకల్యాణ
lOlOpalE	లోలోపలే
lOnE	లోనే
lOnavutuMTAru	లోనవుతుంటారు
lOni	లోని
lOpAla	లోపాల
lOpAlaku	లోపాలకు
lOpAlannI	లోపాలన్నీ
lOpAlu	లోపాలు
lOpAniki	లోపానికి
lOpaM	లోపం
lOpalE	లోపలే
lOpala	లోపల
lOpaliki	లోపలికి
lOtaina	లోతైన
lOtugA	లోతుగా
lU	లూ
la	ల
laDDU	లడ్డూ
laDDUlU	లడ్డూలూ
laDDUlu	లడ్డూలు
lab	లబ్
labhiMcE	లభించే
labhistAyi	లభిస్తాయి
labhistuMTuMdi	లభిస్తుంటుంది
labhistuMdani	లభిస్తుందని
labhistuMdi	లభిస్తుంది
lagEjI	లగేజీ
lagEjIni	లగేజీని
lagjarI	లగ్జరీ
lagnaM	లగ్నం
laiMgikAnubhavamE	లైంగికానుభవమే
laiMgika	లైంగిక
laiMgikaMgA	లైంగికంగా
laiMgikaparamaina	లైంగికపరమైన
lain	లైన్
laksha	లక్ష
lakshaNAlu	లక్షణాలు
lakshabiLvArcana	లక్షబిళ్వార్చన
lakshabilvArcana	లక్షబిల్వార్చన
lakshalAdi	లక్షలాది
lakshala	లక్షల
lakshalamaMdi	లక్షలమంది
lakshmI	లక్ష్మీ
lakshmInArAyaNuDikI	లక్ష్మీనారాయణుడికీ
lakshmInArAyaNuDu	లక్ష్మీనారాయణుడు
lakshmIpatE	లక్ష్మీపతే
lakshyAlanu	లక్ష్యాలను
lakshyaM	లక్ష్యం
laku	లకు
lalO	లలో
lanI	లనీ
laukika	లౌకిక
laya	లయ
leTar	లెటర్
leTla	లెట్ల
lekka	లెక్క
lekkalu	లెక్కలు
lekkiMcaDAniki	లెక్కించడానికి
lekkiMcukunE	లెక్కించుకునే
liMgAnni	లింగాన్ని
liMga	లింగ
liMgaM	లింగం
liMgaMdinnelaku	లింగందిన్నెలకు
liMgamanikUDA	లింగమనికూడా
liMgapUjala	లింగపూజల
libiDO	లిబిడో
limiTeD	లిమిటెడ్
lu	లు
mA	మా
mAMsaM	మాంసం
mANikyAMbA	మాణిక్యాంబా
mANikyAMba	మాణిక్యాంబ
mANikyAMbatO	మాణిక్యాంబతో
mATa	మాట
mATakostE	మాటకొస్తే
mATaku	మాటకు
mATatO	మాటతో
mATiccADu	మాటిచ్చాడు
mATlADaTAniki	మాట్లాడటానికి
mATlADaTAnikoccADu	మాట్లాడటానికొచ్చాడు
mATlADakuMDA	మాట్లాడకుండా
mATlADatAru	మాట్లాడతారు
mATlADi	మాట్లాడి
mATlADukOvaTaM	మాట్లాడుకోవటం
mATlADukuMdAM	మాట్లాడుకుందాం
mATlADukunnAM	మాట్లాడుకున్నాం
mATlADutU	మాట్లాడుతూ
mAdirE	మాదిరే
mAdiri	మాదిరి
mAdirigAnE	మాదిరిగానే
mAgha	మాఘ
mAghaMta	మాఘంత
mAghaSuddha	మాఘశుద్ధ
mAghamAsaMlO	మాఘమాసంలో
mAkEmiTI	మాకేమిటీ
mAmUlukannA	మామూలుకన్నా
mAnasikAMSAlannI	మానసికాంశాలన్నీ
mAnasika	మానసిక
mAnasikaMgA	మానసికంగా
mAnasikamainavEnani	మానసికమైనవేనని
mAnasikamainavEnanna	మానసికమైనవేనన్న
mAnava	మానవ
mAnavuDi	మానవుడి
mAraTAniki	మారటానికి
mAratAru	మారతారు
mAratAyi	మారతాయి
mArcAru	మార్చారు
mArci	మార్చి
mArciMdi	మార్చింది
mArcukuMTU	మార్చుకుంటూ
mArgAlanu	మార్గాలను
mArgAllO	మార్గాల్లో
mArgAlu	మార్గాలు
mArgAnnE	మార్గాన్నే
mArgaM	మార్గం
mArgaMlO	మార్గంలో
mArgaSira	మార్గశిర
mArgamadhyaMlO	మార్గమధ్యంలో
mArgamani	మార్గమని
mAriMdani	మారిందని
mAriMdi	మారింది
mAripOtuMTAyani	మారిపోతుంటాయని
mAripOtunna	మారిపోతున్న
mAripOvaccu	మారిపోవచ్చు
mAripOyAyi	మారిపోయాయి
mAripOyiMdi	మారిపోయింది
mArkulU	మార్కులూ
mArkulu	మార్కులు
mAroccu	మారొచ్చు
mArpEmI	మార్పేమీ
mArpiDi	మార్పిడి
mArpu	మార్పు
mArpulE	మార్పులే
mArpula	మార్పుల
mArpulani	మార్పులని
mArpulanu	మార్పులను
mArpulatO	మార్పులతో
mArpulivi	మార్పులివి
mArpulu	మార్పులు
mArutuMdanna	మారుతుందన్న
mArutuMdi	మారుతుంది
mAsOtsava	మాసోత్సవ
mAsTars	మాస్టర్స్
mAsTekTamI	మాస్టెక్టమీ
mAsaMlO	మాసంలో
mAtRSrI	మాతృశ్రీ
mAta	మాత
mAtraM	మాత్రం
mAtralu	మాత్రలు
mAtramE	మాత్రమే
mEM	మేం
mElkoMTAru	మేల్కొంటారు
mElu	మేలు
mEmU	మేమూ
mEnEjar	మేనేజర్
mErakE	మేరకే
mEraku	మేరకు
mI	మీ
mIdA	మీదా
mIdE	మీదే
mIda	మీద
mIdaMDE	మీదండే
mIdi	మీది
mIdiki	మీదికి
mIduMDE	మీదుండే
mIdugA	మీదుగా
mIdugAnE	మీదుగానే
mIru	మీరు
mODarn	మోడర్న్
mOdI	మోదీ
mOgAlsinacOTa	మోగాల్సినచోట
mOgistuMTAru	మోగిస్తుంటారు
mOgutuMdEmO	మోగుతుందేమో
mOhaM	మోహం
mOkALla	మోకాళ్ల
mOkshaM	మోక్షం
mOsE	మోసే
mOsagALlugA	మోసగాళ్లుగా
mOstaru	మోస్తరు
mOstunnAru	మోస్తున్నారు
mOstunnaTTu	మోస్తున్నట్టు
mOsulettE	మోసులెత్తే
mOtAdulO	మోతాదులో
mOtAdulu	మోతాదులు
mOyAlani	మోయాలని
mRgayA	మృగయా
mUDO	మూడో
mUDu	మూడు
mUDurOjula	మూడురోజుల
mUDurOjulu	మూడురోజులు
mUlAlekkaDannadi	మూలాలెక్కడన్నది
mUlAlu	మూలాలు
mUlaM	మూలం
mUlaMgA	మూలంగా
mUlaMgAnI	మూలంగానీ
mUlagA	మూలగా
mUlakAraNaM	మూలకారణం
mUlallOnU	మూలల్లోనూ
mUlapuTamma	మూలపుటమ్మ
mUlavirATTu	మూలవిరాట్టు
mUrca	మూర్చ
mUrti	మూర్తి
mUrtigA	మూర్తిగా
mUtra	మూత్ర
maLlI	మళ్లీ
maMDalaM	మండలం
maMDalaMlOni	మండలంలోని
maMDapAniki	మండపానికి
maMDapaMgA	మండపంగా
maMDapaMlO	మండపంలో
maMTapAlani	మంటపాలని
maMTapAlu	మంటపాలు
maMTapAlunnAyi	మంటపాలున్నాయి
maMTapaM	మంటపం
maMcaMpai	మంచంపై
maMci	మంచి
maMcidi	మంచిది
maMcikE	మంచికే
maMdakoDigA	మందకొడిగా
maMdi	మంది
maMdiki	మందికి
maMdini	మందిని
maMdirAniki	మందిరానికి
maMdira	మందిర
maMdiraM	మందిరం
maMdulEsukOvaccu	మందులేసుకోవచ్చు
maMdula	మందుల
maMdulu	మందులు
maMdunu	మందును
maMgaLa	మంగళ
maMgaLavAraM	మంగళవారం
maMtrAnni	మంత్రాన్ని
maTTilO	మట్టిలో
maTTipOsi	మట్టిపోసి
maThaM	మఠం
madanapalli	మదనపల్లి
madhumEhaM	మధుమేహం
madhyAhnaM	మధ్యాహ్నం
madhyAhnavELa	మధ్యాహ్నవేళ
madhyE	మధ్యే
madhya	మధ్య
madhyalO	మధ్యలో
madhyavayasulO	మధ్యవయసులో
madi	మది
madrAs	మద్రాస్
madyaM	మద్యం
magavAriki	మగవారికి
mahASivarAtrigA	మహాశివరాత్రిగా
mahAbhArata	మహాభారత
mahAdESikan	మహాదేశికన్
mahAdvArAlu	మహాద్వారాలు
mahAdvAraM	మహాద్వారం
mahAgaNapati	మహాగణపతి
mahAlakshmi	మహాలక్ష్మి
mahAnubhAvulu	మహానుభావులు
mahAprasAdaMgA	మహాప్రసాదంగా
mahAtIrthaMgA	మహాతీర్థంగా
mahAtapassu	మహాతపస్సు
mahAvishNuvE	మహావిష్ణువే
mahAvishNuvu	మహావిష్ణువు
mahAvishNuvuni	మహావిష్ణువుని
mahESvarI	మహేశ్వరీ
mahESvarulaku	మహేశ్వరులకు
mahIMdrA	మహీంద్రా
mahOtsavAniki	మహోత్సవానికి
maha	మహ
mahadbhAgya	మహద్భాగ్య
maharshi	మహర్షి
maharshiki	మహర్షికి
maharshila	మహర్షిల
mahatyaMlO	మహత్యంలో
mahiLalaki	మహిళలకి
mahiLalaku	మహిళలకు
mahiLallO	మహిళల్లో
mahiLalu	మహిళలు
mahimE	మహిమే
mahima	మహిమ
mahimalni	మహిమల్ని
mahimalu	మహిమలు
mahimanU	మహిమనూ
maikrOsUcars	మైక్రోసూచర్స్
maikrOsarjarI	మైక్రోసర్జరీ
maimaracipOyi	మైమరచిపోయి
maisUr	మైసూర్
maitrI	మైత్రీ
majA	మజా
malTipul	మల్టిపుల్
mala	మల
malinAlu	మలినాలు
malivayasulO	మలివయసులో
malupu	మలుపు
mammalni	మమ్మల్ని
manE	మనే
manOharamaina	మనోహరమైన
mana	మన
manaHsthitini	మనఃస్థితిని
manaM	మనం
manaMdaraM	మనందరం
manadi	మనది
manaki	మనకి
manaku	మనకు
manakunna	మనకున్న
manalAMTi	మనలాంటి
manalO	మనలో
manalni	మనల్ని
manasE	మనసే
manasU	మనసూ
manasaMtA	మనసంతా
manassunU	మనస్సునూ
manastatvavEtta	మనస్తత్వవేత్త
manasu	మనసు
manasuku	మనసుకు
manasulO	మనసులో
manasulOki	మనసులోకి
manasulOnE	మనసులోనే
manasulOni	మనసులోని
manasullO	మనసుల్లో
manasunu	మనసును
manasupainA	మనసుపైనా
mani	మని
manishi	మనిషి
manishiki	మనిషికి
manishilOnU	మనిషిలోనూ
manishini	మనిషిని
mannana	మన్నన
manugaDa	మనుగడ
manugaDaku	మనుగడకు
manugaDalanu	మనుగడలను
manushula	మనుషుల
manushulu	మనుషులు
manuvADAlani	మనువాడాలని
marE	మరే
marI	మరీ
marO	మరో
marOvaipu	మరోవైపు
maraNAnaMtaraM	మరణానంతరం
maraNAnmuktiH	మరణాన్ముక్తిః
maraNaM	మరణం
maracipOkuMDA	మరచిపోకుండా
marammatuku	మరమ్మతుకు
marammatulu	మరమ్మతులు
marcipOkUDadu	మర్చిపోకూడదు
marcipOtAnEmO	మర్చిపోతానేమో
marennO	మరెన్నో
marevarU	మరెవరూ
mari	మరి
mariMta	మరింత
mariMtagA	మరింతగా
marikoMdaru	మరికొందరు
marinni	మరిన్ని
marmaM	మర్మం
marnADE	మర్నాడే
marnADu	మర్నాడు
maroka	మరొక
marokari	మరొకరి
mathanapaDutuMTAru	మథనపడుతుంటారు
maunAnni	మౌనాన్ని
meDikal	మెడికల్
meDisin	మెడిసిన్
meMtulU	మెంతులూ
meTTu	మెట్టు
meTluMTAyi	మెట్లుంటాయి
mecci	మెచ్చి
meccina	మెచ్చిన
medaDu	మెదడు
medaDuku	మెదడుకు
medaDulO	మెదడులో
medaDunu	మెదడును
mejAriTI	మెజారిటీ
melagAlsina	మెలగాల్సిన
melakuva	మెలకువ
meligEMdukU	మెలిగేందుకూ
mellagA	మెల్లగా
melugutU	మెలుగుతూ
merugaina	మెరుగైన
merugavutAyi	మెరుగవుతాయి
merugavutOMdA	మెరుగవుతోందా
merugavutuMdi	మెరుగవుతుంది
merugavutunna	మెరుగవుతున్న
merugavvaTAniki	మెరుగవ్వటానికి
mi	మి
miMcina	మించిన
miMcipOtunna	మించిపోతున్న
miSramaMtO	మిశ్రమంతో
migatA	మిగతా
migilina	మిగిలిన
minnaMTutuMdi	మిన్నంటుతుంది
mirapa	మిరప
mitimIrakuMDA	మితిమీరకుండా
modaTa	మొదట
modaTi	మొదటి
modaTisArigA	మొదటిసారిగా
modalaina	మొదలైన
modalainappuDu	మొదలైనప్పుడు
modalavutuMdi	మొదలవుతుంది
modalayyAyi	మొదలయ్యాయి
modaleTTEvAru	మొదలెట్టేవారు
modaleTTagAnE	మొదలెట్టగానే
modalu	మొదలు
modalupeTToccu	మొదలుపెట్టొచ్చు
mokkADA	మొక్కాడా
mokku	మొక్కు
mokkubaDi	మొక్కుబడి
molakettutAyi	మొలకెత్తుతాయి
molustuMDaTaM	మొలుస్తుండటం
mottAnikE	మొత్తానికే
mottAniki	మొత్తానికి
mottaM	మొత్తం
mottammIda	మొత్తమ్మీద
muDipaDi	ముడిపడి
muDipaDina	ముడిపడిన
muDipeTTi	ముడిపెట్టి
muMbayilOni	ముంబయిలోని
muMdE	ముందే
muMdastu	ముందస్తు
muMdastugA	ముందస్తుగా
muMdu	ముందు
muMdugA	ముందుగా
muMdugAnE	ముందుగానే
muMdukeLlalEdu	ముందుకెళ్లలేదు
muMduku	ముందుకు
muMdurOjE	ముందురోజే
muMdurOju	ముందురోజు
muMgurulni	ముంగురుల్ని
muTTukOvAlani	ముట్టుకోవాలని
muTTukOvaTaM	ముట్టుకోవటం
muccaTa	ముచ్చట
muccaTani	ముచ్చటని
muddalA	ముద్దలా
mudra	ముద్ర
mudralu	ముద్రలు
mudritamavutuMdi	ముద్రితమవుతుంది
mudusali	ముదుసలి
muggurammala	ముగ్గురమ్మల
mugiMceyyAlanna	ముగించెయ్యాలన్న
mugiSAka	ముగిశాక
mugisina	ముగిసిన
mugisipOyEvi	ముగిసిపోయేవి
mugustuMdi	ముగుస్తుంది
muhUrtaM	ముహూర్తం
mujjagAlakU	ముజ్జగాలకూ
mukEsh	ముకేష్
mukhAnni	ముఖాన్ని
mukhaM	ముఖం
mukhaMpai	ముఖంపై
mukhaikapAda	ముఖైకపాద
mukhyaM	ముఖ్యం
mukhyaMgA	ముఖ్యంగా
mukhyamO	ముఖ్యమో
mukhyamaMtri	ముఖ్యమంత్రి
mukhyamaina	ముఖ్యమైన
mukhyamainavEgAnI	ముఖ్యమైనవేగానీ
mukhyamani	ముఖ్యమని
mukkaMTini	ముక్కంటిని
mukku	ముక్కు
mukkulu	ముక్కులు
mukkutO	ముక్కుతో
mullOkAla	ముల్లోకాల
mullOkAllOni	ముల్లోకాల్లోని
munISvaruDu	మునీశ్వరుడు
munigipOvu	మునిగిపోవు
munmuMdu	మున్ముందు
munupu	మునుపు
mupphai	ముప్ఫై
muppu	ముప్పు
muppulU	ముప్పులూ
muppulu	ముప్పులు
murikipanilA	మురికిపనిలా
nA	నా
nADu	నాడు
nADula	నాడుల
nALlalO	నాళ్లలో
nAT	నాట్
nATi	నాటి
nATu	నాటు
nATuvaidyulugA	నాటువైద్యులుగా
nATya	నాట్య
nAdi	నాది
nAgadEvatanU	నాగదేవతనూ
nAgadOsha	నాగదోష
nAgarIka	నాగరీక
nAgarikata	నాగరికత
nAgarikatalOnU	నాగరికతలోనూ
nAgarikatalanniMTilOnU	నాగరికతలన్నింటిలోనూ
nAkE	నాకే
nAkOsaM	నాకోసం
nAkishTaM	నాకిష్టం
nAku	నాకు
nAlO	నాలో
nAlugO	నాలుగో
nAlugu	నాలుగు
nAluguvaipulA	నాలుగువైపులా
nAmamE	నామమే
nAnA	నానా
nAnATikI	నానాటికీ
nArAyaNatIrthulavAru	నారాయణతీర్థులవారు
nArAyaNavanaM	నారాయణవనం
nArAyaNuDu	నారాయణుడు
nArasiMha	నారసింహ
nArasiMhuDu	నారసింహుడు
nAsti	నాస్తి
nAvalO	నావలో
nAvanu	నావను
nAvikulu	నావికులు
nAyakuDu	నాయకుడు
nAyuDu	నాయుడు
nEDu	నేడు
nETi	నేటి
nETikI	నేటికీ
nEcar	నేచర్
nEla	నేల
nElapai	నేలపై
nEnE	నేనే
nEnu	నేను
nEpathyaM	నేపథ్యం
nEpathyaMlO	నేపథ్యంలో
nErcukOvaTaM	నేర్చుకోవటం
nErpEdi	నేర్పేది
nErpistuMdi	నేర్పిస్తుంది
nErugA	నేరుగా
nEtraparvaM	నేత్రపర్వం
nI	నీ
nILlu	నీళ్లు
nILlujallEvi	నీళ్లుజల్లేవి
nITilO	నీటిలో
nITitO	నీటితో
nIkE	నీకే
nIli	నీలి
nItA	నీతా
nRtyAlu	నృత్యాలు
nU	నూ
nUTa	నూట
nUTanalabhai	నూటనలభై
nUTiki	నూటికి
nUrELla	నూరేళ్ల
nUru	నూరు
nUtana	నూతన
na	న
naDavalEni	నడవలేని
naDicE	నడిచే
naDicina	నడిచిన
naDuma	నడుమ
naDustuMTAyi	నడుస్తుంటాయి
naDustunnappuDu	నడుస్తున్నప్పుడు
naMbarlalO	నంబర్లలో
naMdi	నంది
naMdyAla	నంద్యాల
naTarAju	నటరాజు
naTistuMTE	నటిస్తుంటే
nadImArgAna	నదీమార్గాన
nagadu	నగదు
nagaramE	నగరమే
naipuNyAlanU	నైపుణ్యాలనూ
naitikamaina	నైతికమైన
naitikaparamaina	నైతికపరమైన
najarAnAlu	నజరానాలు
nakilI	నకిలీ
nakshatraM	నక్షత్రం
nalabhai	నలభై
nalgoMDa	నల్గొండ
nallabOrDu	నల్లబోర్డు
nallamala	నల్లమల
nalugurilO	నలుగురిలో
nalugutunna	నలుగుతున్న
namOdai	నమోదై
namaHpArvatIpatayE	నమఃపార్వతీపతయే
namaSSivAya	నమశ్శివాయ
namakAniki	నమకానికి
namaskArAlu	నమస్కారాలు
nammALvAr	నమ్మాళ్వార్
nammakAllO	నమ్మకాల్లో
nammakaM	నమ్మకం
nammika	నమ్మిక
nammutunna	నమ్ముతున్న
nannaya	నన్నయ
nannu	నన్ను
napuMsaka	నపుంసక
napuMsakatvaM	నపుంసకత్వం
napuMsakulU	నపుంసకులూ
narAla	నరాల
narAlu	నరాలు
narEMdra	నరేంద్ర
narEMdruDi	నరేంద్రుడి
narahari	నరహరి
narasiMha	నరసింహ
narasiMharAyalu	నరసింహరాయలు
narasiMhasvAmi	నరసింహస్వామి
narasiMhavarma	నరసింహవర్మ
narasiMhuDu	నరసింహుడు
narasiMhula	నరసింహుల
narasiMhuni	నరసింహుని
nashTaM	నష్టం
naukarI	నౌకరీ
navAbula	నవాబుల
nava	నవ
navagrahAlu	నవగ్రహాలు
navagraha	నవగ్రహ
navaratnAlu	నవరత్నాలు
navayavvana	నవయవ్వన
navayavvanaM	నవయవ్వనం
nayaM	నయం
nayamaiMdi	నయమైంది
nayamaina	నయమైన
neT	నెట్
neTTukoni	నెట్టుకొని
nelA	నెలా
nela	నెల
nelakoMdani	నెలకొందని
nelakonE	నెలకొనే
nelakonaTaM	నెలకొనటం
nelakoni	నెలకొని
nelakonna	నెలకొన్న
nelalO	నెలలో
nelala	నెలల
nelalakOsAri	నెలలకోసారి
nelallO	నెలల్లో
nelalu	నెలలు
nelasari	నెలసరి
nelavugA	నెలవుగా
nemmadigA	నెమ్మదిగా
neravErcukunEMduku	నెరవేర్చుకునేందుకు
nes	నెస్
ni	ని
niMDA	నిండా
niMDi	నిండి
niMDugA	నిండుగా
niMdiMcaTaM	నిందించటం
niScalaMgA	నిశ్చలంగా
niScayaM	నిశ్చయం
niScayiMcukoMTuMdi	నిశ్చయించుకొంటుంది
niScitaMgA	నిశ్చితంగా
niTalAkshuni	నిటలాక్షుని
nibaMdhanalEmI	నిబంధనలేమీ
nibaMdhanalU	నిబంధనలూ
nibaMdhanalu	నిబంధనలు
nidarSanaM	నిదర్శనం
nidrAbhaMgaM	నిద్రాభంగం
nidra	నిద్ర
nidraku	నిద్రకు
nidralEmi	నిద్రలేమి
nidralEvaTAniki	నిద్రలేవటానికి
nidralO	నిద్రలో
nidrapaDutuMdi	నిద్రపడుతుంది
nigAriMcE	నిగారించే
niganigalADE	నిగనిగలాడే
nijAniki	నిజానికి
nijaMgAnE	నిజంగానే
nijajIvitaMlO	నిజజీవితంలో
nijamaina	నిజమైన
nijamani	నిజమని
nijamanukoni	నిజమనుకొని
nilabaDE	నిలబడే
nilabaDEMtavarakU	నిలబడేంతవరకూ
nilabaDi	నిలబడి
nilabaDinappuDu	నిలబడినప్పుడు
niladIyaTaM	నిలదీయటం
nilaya	నిలయ
nilicADaTa	నిలిచాడట
nilicE	నిలిచే
nilicEdi	నిలిచేది
nilustAyani	నిలుస్తాయని
nilustuMdi	నిలుస్తుంది
niluvaristADu	నిలువరిస్తాడు
niluvellA	నిలువెల్లా
nimaraTaM	నిమరటం
nimishAla	నిమిషాల
nimishAlakO	నిమిషాలకో
nimishAlaku	నిమిషాలకు
nimishAlanu	నిమిషాలను
nimishAlu	నిమిషాలు
nimishAnikO	నిమిషానికో
nimishaM	నిమిషం
nimittaM	నిమిత్తం
nippu	నిప్పు
nipuNula	నిపుణుల
nipuNulu	నిపుణులు
nirASaku	నిరాశకు
nirASalOki	నిరాశలోకి
nirAsaktata	నిరాసక్తత
nirNayaM	నిర్ణయం
nirNayiMciMdi	నిర్ణయించింది
nirNayiMcukunnADaTa	నిర్ణయించుకున్నాడట
nirNayiMcukunnArAme	నిర్ణయించుకున్నారామె
nirNayistADu	నిర్ణయిస్తాడు
nirOdhaka	నిరోధక
niraMtaraM	నిరంతరం
nirdESiMciMdi	నిర్దేశించింది
nirdESiMcina	నిర్దేశించిన
nirdESita	నిర్దేశిత
nirdhAriMcaTaM	నిర్ధారించటం
nirdishTamaina	నిర్దిష్టమైన
nirmANAlanu	నిర్మాణాలను
nirmANa	నిర్మాణ
nirmANaM	నిర్మాణం
nirmANaMpai	నిర్మాణంపై
nirmANaSaili	నిర్మాణశైలి
nirmalaMgA	నిర్మలంగా
nirmiMcADani	నిర్మించాడని
nirmiMcAru	నిర్మించారు
nirmiMcina	నిర్మించిన
nirmistU	నిర్మిస్తూ
nirthAraNa	నిర్థారణ
nirutsAhaM	నిరుత్సాహం
nirvEdaMlOki	నిర్వేదంలోకి
nirvIryamaipOtuMTuMdi	నిర్వీర్యమైపోతుంటుంది
nirvahiMcE	నిర్వహించే
nirvahiMcEMduku	నిర్వహించేందుకు
nirvahiMci	నిర్వహించి
nirvahiMciMdi	నిర్వహించింది
nirvahiMcina	నిర్వహించిన
nirvahiMcukunna	నిర్వహించుకున్న
nirvahistAru	నిర్వహిస్తారు
nirvahistOMdi	నిర్వహిస్తోంది
nirvahistunnAru	నిర్వహిస్తున్నారు
nirvahistunna	నిర్వహిస్తున్న
nirvighnaMgA	నిర్విఘ్నంగా
nirvighnamastu	నిర్విఘ్నమస్తు
nishEdhaM	నిషేధం
nishiddha	నిషిద్ధ
nishiddhapadaM	నిషిద్ధపదం
nissAramaina	నిస్సారమైన
nissattuva	నిస్సత్తువ
nityOtsavAlni	నిత్యోత్సవాల్ని
nityOtsava	నిత్యోత్సవ
nitya	నిత్య
nityaM	నిత్యం
nityapUjalu	నిత్యపూజలు
nivAraNakE	నివారణకే
nivAriMcukOvaTAnikE	నివారించుకోవటానికే
nivAriMcukOvaccu	నివారించుకోవచ్చు
nivRtti	నివృత్తి
nivasistE	నివసిస్తే
niyAmakAla	నియామకాల
niyAmaka	నియామక
niyOjakavargaMlOni	నియోజకవర్గంలోని
niyaMtraNa	నియంత్రణ
niyamAlu	నియమాలు
nokki	నొక్కి
nokkukupOyi	నొక్కుకుపోయి
noppi	నొప్పి
nu	ను
nuMcE	నుంచే
nuMcI	నుంచీ
nuMcO	నుంచో
nuMci	నుంచి
nunnaTi	నున్నటి
nuvvugiMjaMta	నువ్వుగింజంత
oDDuku	ఒడ్డుకు
oDDuna	ఒడ్డున
oDiduDukulatO	ఒడిదుడుకులతో
oMTabaTTiMcukuMTAru	ఒంటబట్టించుకుంటారు
oMTarigAnE	ఒంటరిగానే
oMTelU	ఒంటెలూ
oMTiki	ఒంటికి
oMTlO	ఒంట్లో
oMTlOMci	ఒంట్లోంచి
oMTlOnU	ఒంట్లోనూ
okE	ఒకే
okElA	ఒకేలా
oka	ఒక
okaTE	ఒకటే
okaTi	ఒకటి
okaTigA	ఒకటిగా
okaTinnara	ఒకటిన్నర
okappaTilA	ఒకప్పటిలా
okappuDu	ఒకప్పుడు
okarOju	ఒకరోజు
okari	ఒకరి
okariki	ఒకరికి
okarinE	ఒకరినే
okarini	ఒకరిని
okarinokaru	ఒకరినొకరు
okaripai	ఒకరిపై
okaru	ఒకరు
okasAri	ఒకసారి
okasArigAnI	ఒకసారిగానీ
okavELa	ఒకవేళ
okavaipu	ఒకవైపు
okkO	ఒక్కో
okkOrOju	ఒక్కోరోజు
okkOvidhaMgA	ఒక్కోవిధంగా
okka	ఒక్క
okkaTE	ఒక్కటే
okkaTainA	ఒక్కటైనా
okkaTi	ఒక్కటి
okkarOjainA	ఒక్కరోజైనా
okkarOju	ఒక్కరోజు
okkariki	ఒక్కరికి
okkarilO	ఒక్కరిలో
okkasArigA	ఒక్కసారిగా
oliMpik	ఒలింపిక్
oliMpiks	ఒలింపిక్స్
onagUDE	ఒనగూడే
oppaMdaM	ఒప్పందం
oppiMcAlO	ఒప్పించాలో
orEy	ఒరేయ్
orissA	ఒరిస్సా
ottiDi	ఒత్తిడి
ottiDini	ఒత్తిడిని
ottiLlalO	ఒత్తిళ్లలో
ottiLlatO	ఒత్తిళ్లతో
pADubaDDa	పాడుబడ్డ
pAScAtya	పాశ్చాత్య
pASupatAstraMtO	పాశుపతాస్త్రంతో
pATU	పాటూ
pAThAlani	పాఠాలని
pAThAlu	పాఠాలు
pAThyapustakaM	పాఠ్యపుస్తకం
pATiMcaTaM	పాటించటం
pATiMcani	పాటించని
pATiyAlA	పాటియాలా
pATu	పాటు
pAdAlaku	పాదాలకు
pAdapadmAlni	పాదపద్మాల్ని
pAdulatO	పాదులతో
pAkshikaMgA	పాక్షికంగా
pAlakollulO	పాలకొల్లులో
pAlakuDaina	పాలకుడైన
pAlakuDigA	పాలకుడిగా
pAlakuDu	పాలకుడు
pAlanA	పాలనా
pAlanalO	పాలనలో
pAlanalOki	పాలనలోకి
pAlgonE	పాల్గొనే
pAlgonalEkapOvaccu	పాల్గొనలేకపోవచ్చు
pAlgonalEni	పాల్గొనలేని
pAlgoni	పాల్గొని
pAlgonnA	పాల్గొన్నా
pAlgonnAyi	పాల్గొన్నాయి
pAliMcina	పాలించిన
pAlistunna	పాలిస్తున్న
pAmula	పాముల
pAnIyAlanU	పానీయాలనూ
pApAlU	పాపాలూ
pApAlanu	పాపాలను
pApAlu	పాపాలు
pApabhAraM	పాపభారం
pApanASanaM	పాపనాశనం
pApaparihAramautuMdani	పాపపరిహారమౌతుందని
pArE	పారే
pArSAvallOnU	పార్శా్వల్లోనూ
pAripOtAyani	పారిపోతాయని
pAripOtE	పారిపోతే
pArk	పార్క్
pArutU	పారుతూ
pAruvETOtsavAlaku	పారువేటోత్సవాలకు
pAruvETOtsavAllO	పారువేటోత్సవాల్లో
pAruvETOtsavAlu	పారువేటోత్సవాలు
pAruvETa	పారువేట
pArvETOtsavAlu	పార్వేటోత్సవాలు
pAtALaMnuMci	పాతాళంనుంచి
pAta	పాత
pAtra	పాత్ర
pAtrala	పాత్రల
pAtralunnAyi	పాత్రలున్నాయి
pETa	పేట
pEdAdhanikA	పేదాధనికా
pEdOLlu	పేదోళ్లు
pEda	పేద
pEparlu	పేపర్లు
pEraMTAniki	పేరంటానికి
pErkoMTAru	పేర్కొంటారు
pErkoMTunnAyi	పేర్కొంటున్నాయి
pErkoMdi	పేర్కొంది
pErkonnAru	పేర్కొన్నారు
pErkonnAyi	పేర్కొన్నాయి
pErlanu	పేర్లను
pErlatO	పేర్లతో
pEroMdina	పేరొందిన
pEru	పేరు
pErutO	పేరుతో
pIDala	పీడల
pIDiMcE	పీడించే
pIDistuMTuMdi	పీడిస్తుంటుంది
pIDitulu	పీడితులు
pIThAdhipati	పీఠాధిపతి
pIThAdhipatiki	పీఠాధిపతికి
pIThAlu	పీఠాలు
pIThaM	పీఠం
pIlcinappuDu	పీల్చినప్పుడు
pIlcukOka	పీల్చుకోక
pInail	పీనైల్
pIvI	పీవీ
pOTI	పోటీ
pOTIpaDatAru	పోటీపడతారు
pOTIparIkshala	పోటీపరీక్షల
pOTettutAru	పోటెత్తుతారు
pOcammatalli	పోచమ్మతల్లి
pOgoTTukunna	పోగొట్టుకున్న
pOlina	పోలిన
pOlistE	పోలిస్తే
pOnI	పోనీ
pOrADutuMdani	పోరాడుతుందని
pOshiMcAlsi	పోషించాల్సి
pOshiMcukuMTU	పోషించుకుంటూ
pOshistuMTuMdi	పోషిస్తుంటుంది
pOshistuMdi	పోషిస్తుంది
pOtAyani	పోతాయని
pOtuMdanna	పోతుందన్న
pOtunnAyi	పోతున్నాయి
pOvAli	పోవాలి
pOvaTaMlO	పోవటంలో
pOvaccu	పోవచ్చు
pOyi	పోయి
pOyiMdi	పోయింది
pUTa	పూట
pUjAdikAlu	పూజాదికాలు
pUja	పూజ
pUjaku	పూజకు
pUjala	పూజల
pUjalaMdukoMTunnAyi	పూజలందుకొంటున్నాయి
pUjalaMdukuMTADu	పూజలందుకుంటాడు
pUjalaMdukuMTOMdi	పూజలందుకుంటోంది
pUjalaMdukuMTunnADu	పూజలందుకుంటున్నాడు
pUjalaku	పూజలకు
pUjalu	పూజలు
pUjiMcADaTa	పూజించాడట
pUjistE	పూజిస్తే
pUrNima	పూర్ణిమ
pUrtaiMdi	పూర్తైంది
pUrtavutAyi	పూర్తవుతాయి
pUrtayina	పూర్తయిన
pUrti	పూర్తి
pUrticESADanI	పూర్తిచేశాడనీ
pUrtigA	పూర్తిగా
pUrtisthAyilO	పూర్తిస్థాయిలో
pUrvIkulu	పూర్వీకులు
pUrvavaibhava	పూర్వవైభవ
pUrvikuDaina	పూర్వికుడైన
paDAli	పడాలి
paDDArAme	పడ్డారామె
paDDa	పడ్డ
paDDavE	పడ్డవే
paDE	పడే
paDEsE	పడేసే
paDaka	పడక
paDina	పడిన
paDinappuDu	పడినప్పుడు
paDipOvaTaM	పడిపోవటం
paDipOyiMdi	పడిపోయింది
paDoccani	పడొచ్చని
paDukOvAli	పడుకోవాలి
paDukOvaTamE	పడుకోవటమే
paDukoni	పడుకొని
paDukuMTEnE	పడుకుంటేనే
paDutunnA	పడుతున్నా
paLlu	పళ్లు
paMDagaMTE	పండగంటే
paMDitulu	పండితులు
paMDugE	పండుగే
paMDuga	పండుగ
paMDuvayasulO	పండువయసులో
paMTa	పంట
paMcAksharI	పంచాక్షరీ
paMcArAmAlaku	పంచారామాలకు
paMcArAmAllO	పంచారామాల్లో
paMcArAmAllOni	పంచారామాల్లోని
paMcadAra	పంచదార
paMcalOha	పంచలోహ
paMdhommidO	పంధొమ్మిదో
paMpA	పంపా
paScimOttAnAsanaM	పశ్చిమోత్తానాసనం
paTApaMcalu	పటాపంచలు
paTTAlekkiMdi	పట్టాలెక్కింది
paTTE	పట్టే
paTTESAyi	పట్టేశాయి
paTTaNAlatO	పట్టణాలతో
paTTaNAllO	పట్టణాల్లో
paTTaNAniki	పట్టణానికి
paTTalEdu	పట్టలేదు
paTTarAni	పట్టరాని
paTTi	పట్టి
paTTiMcukOkapOvaTaM	పట్టించుకోకపోవటం
paTTiMcukuMTAru	పట్టించుకుంటారు
paTTiMdi	పట్టింది
paTTiMpulu	పట్టింపులు
paTTika	పట్టిక
paTTukOvAlsi	పట్టుకోవాల్సి
paTalaM	పటలం
paTishThaMgA	పటిష్ఠంగా
paTla	పట్ల
paTrApO	పట్రాపో
paTutvAnni	పటుత్వాన్ని
paTutvaM	పటుత్వం
paccaTi	పచ్చటి
paccadanaM	పచ్చదనం
paccani	పచ్చని
paccika	పచ్చిక
padA	పదా
padaM	పదం
padaMgA	పదంగా
padahArO	పదహారో
padavi	పదవి
paddenimidi	పద్దెనిమిది
paddhataitE	పద్ధతైతే
paddhati	పద్ధతి
paddhatini	పద్ధతిని
paddhatulanU	పద్ధతులనూ
paddhatulatO	పద్ధతులతో
paddhatulu	పద్ధతులు
padi	పది
padiSAtaM	పదిశాతం
padmAvati	పద్మావతి
padnAlugELlu	పద్నాలుగేళ్లు
pagaTi	పగటి
pagilE	పగిలే
pai	పై
paibaDina	పైబడిన
paigA	పైగా
paiki	పైకి
pakkaTemukalaku	పక్కటెముకలకు
pakkanE	పక్కనే
pakkiMTlO	పక్కింట్లో
pakshOtsava	పక్షోత్సవ
pakshaMlO	పక్షంలో
pakshavAtaM	పక్షవాతం
pakshulu	పక్షులు
palakariMcAlani	పలకరించాలని
palakariMcEvANni	పలకరించేవాణ్ని
palakaristUnE	పలకరిస్తూనే
pallakI	పల్లకీ
pallakIni	పల్లకీని
pallaki	పల్లకి
pallavarANi	పల్లవరాణి
palu	పలు
pani	పని
panibhAraMtO	పనిభారంతో
panicEsE	పనిచేసే
panicEstAyi	పనిచేస్తాయి
panicEstuMdi	పనిచేస్తుంది
panicEyaDaM	పనిచేయడం
panicEyaniyyavu	పనిచేయనియ్యవు
panikirAdaMTAru	పనికిరాదంటారు
panitIrU	పనితీరూ
panitIru	పనితీరు
panitIrulanu	పనితీరులను
panitIrunu	పనితీరును
panitIrupai	పనితీరుపై
panitOpATu	పనితోపాటు
panitanaM	పనితనం
panneMDu	పన్నెండు
panula	పనుల
panulanu	పనులను
parIksha	పరీక్ష
parIkshagA	పరీక్షగా
parIkshalO	పరీక్షలో
parIkshala	పరీక్షల
parIkshalaMTE	పరీక్షలంటే
parIkshalaku	పరీక్షలకు
parIkshalanagAnE	పరీక్షలనగానే
parIkshalavarakU	పరీక్షలవరకూ
parIkshallO	పరీక్షల్లో
parIkshalu	పరీక్షలు
paracalEkapOtunnAnanE	పరచలేకపోతున్నాననే
paradAla	పరదాల
paragaDupuna	పరగడుపున
paramESvaruDiki	పరమేశ్వరుడికి
paramESvaruDu	పరమేశ్వరుడు
parama	పరమ
paramaSivuDi	పరమశివుడి
paramaina	పరమైన
paravaLlutokkE	పరవళ్లుతొక్కే
pari	పరి
pariDhavillAyi	పరిఢవిల్లాయి
pariNAmAlakU	పరిణామాలకూ
pariNAmAlu	పరిణామాలు
pariSIlana	పరిశీలన
pariSIlanaku	పరిశీలనకు
pariSOdhakula	పరిశోధకుల
pariSOdhakulu	పరిశోధకులు
pariSOdhanA	పరిశోధనా
pariSOdhanallO	పరిశోధనల్లో
pariSOdhanalu	పరిశోధనలు
paricayaM	పరిచయం
parici	పరిచి
paridhilO	పరిధిలో
parigaNanalOki	పరిగణనలోకి
parikarAlu	పరికరాలు
parimitamayyADu	పరిమితమయ్యాడు
paripUrNa	పరిపూర్ణ
paripari	పరిపరి
parisarAllO	పరిసరాల్లో
parisarAllOni	పరిసరాల్లోని
parisarAlu	పరిసరాలు
parishkArAlu	పరిష్కారాలు
parishkAraM	పరిష్కారం
parishkaristADu	పరిష్కరిస్తాడు
paristhitE	పరిస్థితే
paristhitI	పరిస్థితీ
paristhiti	పరిస్థితి
paristhitilO	పరిస్థితిలో
paristhitula	పరిస్థితుల
paristhitullO	పరిస్థితుల్లో
paristhitulu	పరిస్థితులు
parugettaDaM	పరుగెత్తడం
parvadinAllO	పర్వదినాల్లో
parvatavardhini	పర్వతవర్ధిని
paryATaka	పర్యాటక
paryaTana	పర్యటన
paryaTiMcina	పర్యటించిన
paryavasAnaM	పర్యవసానం
pasibiDDala	పసిబిడ్డల
pasibiDDalu	పసిబిడ్డలు
pasitanaM	పసితనం
pasivayasu	పసివయసు
pasivayasulO	పసివయసులో
pataka	పతక
patakaM	పతకం
patanAnaMtaraM	పతనానంతరం
pathakAlanu	పథకాలను
pathakaM	పథకం
patrAla	పత్రాల
patraM	పత్రం
paurANika	పౌరాణిక
paurANikaMgAnU	పౌరాణికంగానూ
paurNami	పౌర్ణమి
paurNaminADu	పౌర్ణమినాడు
pavitrAdbhutamaina	పవిత్రాద్భుతమైన
pavitra	పవిత్ర
pavitramainadani	పవిత్రమైనదని
pavitrata	పవిత్రత
peDamogaMgA	పెడమొగంగా
peDatOva	పెడతోవ
peDutuMTE	పెడుతుంటే
peLlADAlanukunnADaTa	పెళ్లాడాలనుకున్నాడట
peLlADDaM	పెళ్లాడ్డం
peLlai	పెళ్లై
peLlaiMdi	పెళ్లైంది
peLlaina	పెళ్లైన
peLlainakottalO	పెళ్లైనకొత్తలో
peLli	పెళ్లి
peLlibaTTalalO	పెళ్లిబట్టలలో
peLlicUpulu	పెళ్లిచూపులు
peLliki	పెళ్లికి
peMci	పెంచి
peMcina	పెంచిన
peMcukOvaTAniki	పెంచుకోవటానికి
peMcukOvaTaM	పెంచుకోవటం
peMcukOvaTaMlO	పెంచుకోవటంలో
peMcukuMTOMdi	పెంచుకుంటోంది
peMcutAyi	పెంచుతాయి
peMkullO	పెంకుల్లో
peMpakAnikI	పెంపకానికీ
peMpakaM	పెంపకం
peMpoMdi	పెంపొంది
peMpu	పెంపు
peTTAlaMTE	పెట్టాలంటే
peTTAli	పెట్టాలి
peTTAru	పెట్టారు
peTTEdelA	పెట్టేదెలా
peTTakuMDA	పెట్టకుండా
peTTe	పెట్టె
peTTi	పెట్టి
peTTinaMduku	పెట్టినందుకు
peTTukOvAlsina	పెట్టుకోవాల్సిన
peTTukOvaTaM	పెట్టుకోవటం
peTTukOvaccu	పెట్టుకోవచ్చు
peTTukunE	పెట్టుకునే
peTTukuni	పెట్టుకుని
peTrOliyaM	పెట్రోలియం
pedavulanu	పెదవులను
pedda	పెద్ద
peddadi	పెద్దది
peddagA	పెద్దగా
peddalu	పెద్దలు
peddamottaMlO	పెద్దమొత్తంలో
peddapedda	పెద్దపెద్ద
peddavALlu	పెద్దవాళ్లు
peddavainA	పెద్దవైనా
peddavayasulO	పెద్దవయసులో
peddayyAka	పెద్దయ్యాక
pellubikAyi	పెల్లుబికాయి
penu	పెను
penumaLla	పెనుమళ్ల
peraTlO	పెరట్లో
peragAli	పెరగాలి
peragAlsina	పెరగాల్సిన
peragaDaM	పెరగడం
peragaTAniki	పెరగటానికి
peragaTaM	పెరగటం
peragaTamE	పెరగటమే
perigAyi	పెరిగాయి
perigE	పెరిగే
perigi	పెరిగి
perigina	పెరిగిన
periginaTlu	పెరిగినట్లు
perigipOtunnAyani	పెరిగిపోతున్నాయని
perigipOyiMdi	పెరిగిపోయింది
perugutAru	పెరుగుతారు
perugutAyi	పెరుగుతాయి
perugutOMdi	పెరుగుతోంది
perugutuMdani	పెరుగుతుందని
perugutuMdi	పెరుగుతుంది
perugutunnAyi	పెరుగుతున్నాయి
perugutunna	పెరుగుతున్న
perugutunnaTTu	పెరుగుతున్నట్టు
phAdar	ఫాదర్
phArmA	ఫార్మా
phOm	ఫోమ్
phOn	ఫోన్
phOr	ఫోర్
phaMkshan	ఫంక్షన్
phalAnA	ఫలానా
phalamani	ఫలమని
phalitAla	ఫలితాల
phalitAlanE	ఫలితాలనే
phalitAlatO	ఫలితాలతో
phalitAlu	ఫలితాలు
phalitaMgA	ఫలితంగా
phalitamE	ఫలితమే
pharIdAbAd	ఫరీదాబాద్
pherrI	ఫెర్రీ
phiT	ఫిట్
phrAyiD	ఫ్రాయిడ్
phreMDs	ఫ్రెండ్స్
phreMc	ఫ్రెంచ్
phrijiD	ఫ్రిజిడ్
phyUcar	ఫ్యూచర్
piDugulAMTi	పిడుగులాంటి
pilavani	పిలవని
pilicEvAraTa	పిలిచేవారట
pilicEvArani	పిలిచేవారని
pilicEvAru	పిలిచేవారు
pilipiMcAru	పిలిపించారు
pilipiMcukuni	పిలిపించుకుని
pillala	పిల్లల
pillalaku	పిల్లలకు
pillalanu	పిల్లలను
pillalatO	పిల్లలతో
pillallO	పిల్లల్లో
pillalu	పిల్లలు
pilupu	పిలుపు
pilustADu	పిలుస్తాడు
pilustAru	పిలుస్తారు
pinnItO	పిన్నీతో
pinni	పిన్ని
pinniMTiki	పిన్నింటికి
plAsTik	ప్లాస్టిక్
plET	ప్లేట్
poDavATi	పొడవాటి
poDavu	పొడవు
poDavunA	పొడవునా
poDucukOvaTaM	పొడుచుకోవటం
poDuguna	పొడుగున
poMci	పొంచి
poMdAlsinaMtaTi	పొందాల్సినంతటి
poMdAru	పొందారు
poMdE	పొందే
poMdEvAri	పొందేవారి
poMdaTAniki	పొందటానికి
poMdaccu	పొందచ్చు
poMdalEru	పొందలేరు
poMdanunnAru	పొందనున్నారు
poMdavaccu	పొందవచ్చు
poMdiMdi	పొందింది
poMdina	పొందిన
poMdutArani	పొందుతారని
poMgukocciMdi	పొంగుకొచ్చింది
poMgukostuMdi	పొంగుకొస్తుంది
poMtanE	పొంతనే
poMtana	పొంతన
podigAranI	పొదిగారనీ
podivipaTTukOvaTaM	పొదివిపట్టుకోవటం
poga	పొగ
pogoTTukunna	పొగొట్టుకున్న
polAlE	పొలాలే
polAlu	పొలాలు
polaMlO	పొలంలో
pora	పొర
porapATu	పొరపాటు
pottiLla	పొత్తిళ్ల
pottikaDupulO	పొత్తికడుపులో
prAMtAlEpaMcArAmAlani	ప్రాంతాలేపంచారామాలని
prAMtAla	ప్రాంతాల
prAMtAlakU	ప్రాంతాలకూ
prAMtAlanu	ప్రాంతాలను
prAMtAllO	ప్రాంతాల్లో
prAMtAlni	ప్రాంతాల్ని
prAMtAniki	ప్రాంతానికి
prAMtAnni	ప్రాంతాన్ని
prAMtaM	ప్రాంతం
prAMtaMlO	ప్రాంతంలో
prAMtaMlOnE	ప్రాంతంలోనే
prANAlu	ప్రాణాలు
prANAmAya	ప్రాణామాయ
prANAyAmAniki	ప్రాణాయామానికి
prANAyAmaM	ప్రాణాయామం
prANa	ప్రాణ
prANaM	ప్రాణం
prANasakhi	ప్రాణసఖి
prASastyAnni	ప్రాశస్త్యాన్ని
prASastyaM	ప్రాశస్త్యం
prASastyamunna	ప్రాశస్త్యమున్న
prAcInakAlaMlO	ప్రాచీనకాలంలో
prAcInamaina	ప్రాచీనమైన
prAcuryaMlO	ప్రాచుర్యంలో
prAdhAnyAlu	ప్రాధాన్యాలు
prAdhAnyAnni	ప్రాధాన్యాన్ని
prAdhAnyaM	ప్రాధాన్యం
prAdhAnyamuMdi	ప్రాధాన్యముంది
prAdhAnyatanu	ప్రాధాన్యతను
prAkArAla	ప్రాకారాల
prAkArAlu	ప్రాకారాలు
prAkAra	ప్రాకార
prAkAraM	ప్రాకారం
prAkAraMlO	ప్రాకారంలో
prAkAraMlOni	ప్రాకారంలోని
prAkRta	ప్రాకృత
prAmukhyaM	ప్రాముఖ్యం
prApti	ప్రాప్తి
prAraMbhaM	ప్రారంభం
prAraMbhamai	ప్రారంభమై
prAraMbhiMcAru	ప్రారంభించారు
prAsthaTik	ప్రాస్థటిక్
prAthamika	ప్రాథమిక
prAthamikaMgA	ప్రాథమికంగా
prEmAspadamainadani	ప్రేమాస్పదమైనదని
prEmAspadanamaina	ప్రేమాస్పదనమైన
prEma	ప్రేమ
prEmagA	ప్రేమగా
prEmalU	ప్రేమలూ
prEmatO	ప్రేమతో
prErEpistAyi	ప్రేరేపిస్తాయి
prEraNalu	ప్రేరణలు
prEyasi	ప్రేయసి
prIpeyiD	ప్రీపెయిడ్
prItigala	ప్రీతిగల
prItikaraMgA	ప్రీతికరంగా
prItipAtramani	ప్రీతిపాత్రమని
prOdbalaMtO	ప్రోద్బలంతో
prOktaMgA	ప్రోక్తంగా
prOsthesis	ప్రోస్థెసిస్
prOtsahistuMdi	ప్రోత్సహిస్తుంది
praLayahElaku	ప్రళయహేలకు
praNALika	ప్రణాళిక
praNALikaku	ప్రణాళికకు
praNatulaMdukonE	ప్రణతులందుకొనే
praSAMta	ప్రశాంత
praSAMtaMgA	ప్రశాంతంగా
praSAMtamaina	ప్రశాంతమైన
praSAMtatE	ప్రశాంతతే
praSAMtata	ప్రశాంతత
praSAMtataku	ప్రశాంతతకు
praSAMtatanu	ప్రశాంతతను
praSastiki	ప్రశస్తికి
praSnAvaLilu	ప్రశ్నావళిలు
praSnalu	ప్రశ్నలు
prabhAvaM	ప్రభావం
prabhAvitaM	ప్రభావితం
prabhutvAlakU	ప్రభుత్వాలకూ
prabhutvAlu	ప్రభుత్వాలు
prabhutvaM	ప్రభుత్వం
prabhuvaina	ప్రభువైన
pracAraM	ప్రచారం
pracAraMlOki	ప్రచారంలోకి
pradESAlaku	ప్రదేశాలకు
pradESAlanniTinI	ప్రదేశాలన్నిటినీ
pradESAlanu	ప్రదేశాలను
pradESaM	ప్రదేశం
pradESaMlO	ప్రదేశంలో
pradakshiNa	ప్రదక్షిణ
pradakshiNala	ప్రదక్షిణల
pradarSiMcani	ప్రదర్శించని
pradarSistunnAmA	ప్రదర్శిస్తున్నామా
pradhAnAlayaM	ప్రధానాలయం
pradhAnAlayaMtO	ప్రధానాలయంతో
pradhAna	ప్రధాన
pradhAnaMgA	ప్రధానంగా
pradhAnamaMtri	ప్రధానమంత్రి
pradhAnamaina	ప్రధానమైన
pradhAnamani	ప్రధానమని
pradhAni	ప్రధాని
pragADha	ప్రగాఢ
praharI	ప్రహరీ
prahlAdavaraduDu	ప్రహ్లాదవరదుడు
praivETu	ప్రైవేటు
prajApati	ప్రజాపతి
prajala	ప్రజల
prajalakO	ప్రజలకో
prajalaku	ప్రజలకు
prajallO	ప్రజల్లో
prajalu	ప్రజలు
prakAraM	ప్రకారం
prakRti	ప్రకృతి
prakRtiki	ప్రకృతికి
prakaTana	ప్రకటన
prakaTiMcAru	ప్రకటించారు
prakaTiMcina	ప్రకటించిన
prakaTistuMTuMdi	ప్రకటిస్తుంటుంది
prakriya	ప్రక్రియ
prakriyalO	ప్రక్రియలో
prakriyanu	ప్రక్రియను
prakriyapai	ప్రక్రియపై
pramAdAlanu	ప్రమాదాలను
pramAdaM	ప్రమాదం
pramAdaMlO	ప్రమాదంలో
pramAdakara	ప్రమాదకర
pramAdamuMdi	ప్రమాదముంది
pramukhaMgA	ప్రముఖంగా
prapaMcAniki	ప్రపంచానికి
prapaMca	ప్రపంచ
prapaMcaM	ప్రపంచం
prapaMcaMlOki	ప్రపంచంలోకి
prapaMcavyAptaMgA	ప్రపంచవ్యాప్తంగా
prapattulatO	ప్రపత్తులతో
prasAdAnni	ప్రసాదాన్ని
prasAda	ప్రసాద
prasAdistADu	ప్రసాదిస్తాడు
prasAraM	ప్రసారం
prasiddha	ప్రసిద్ధ
prasiddhamai	ప్రసిద్ధమై
prasiddhi	ప్రసిద్ధి
prasiddigAMcina	ప్రసిద్దిగాంచిన
prastAvana	ప్రస్తావన
prastuta	ప్రస్తుత
prastutaM	ప్రస్తుతం
pratAparudruDi	ప్రతాపరుద్రుడి
pratI	ప్రతీ
pratIkAtmakaMgA	ప్రతీకాత్మకంగా
pratIti	ప్రతీతి
pratIyETA	ప్రతీయేటా
prathama	ప్రథమ
pratikUla	ప్రతికూల
pratimalu	ప్రతిమలు
pratiokkarU	ప్రతిఒక్కరూ
pratiphalaM	ప్రతిఫలం
pratiphaliMciMdi	ప్రతిఫలించింది
pratirOjU	ప్రతిరోజూ
pratishThA	ప్రతిష్ఠా
pratishThAtmakamaina	ప్రతిష్ఠాత్మకమైన
pratishThiMcADaTa	ప్రతిష్ఠించాడట
pratishThiMcAru	ప్రతిష్ఠించారు
pratishThiMciMdaTa	ప్రతిష్ఠించిందట
pratishThitamaina	ప్రతిష్ఠితమైన
pratishThituDainaMduku	ప్రతిష్ఠితుడైనందుకు
pratyEka	ప్రత్యేక
pratyEkaMgA	ప్రత్యేకంగా
pratyEkamaina	ప్రత్యేకమైన
pratyEkata	ప్రత్యేకత
pratyakshaM	ప్రత్యక్షం
pratyakshaMgA	ప్రత్యక్షంగా
pravESAlaku	ప్రవేశాలకు
pravESAniki	ప్రవేశానికి
pravESa	ప్రవేశ
pravESaM	ప్రవేశం
pravESamArgaMlO	ప్రవేశమార్గంలో
pravESaparIkshala	ప్రవేశపరీక్షల
pravESiMcE	ప్రవేశించే
pravESiMcaTaM	ప్రవేశించటం
pravESiMcavaccu	ప్రవేశించవచ్చు
pravESistE	ప్రవేశిస్తే
pravRtti	ప్రవృత్తి
pravahistOnna	ప్రవహిస్తోన్న
pravahistU	ప్రవహిస్తూ
pravahistunna	ప్రవహిస్తున్న
pravartanalannI	ప్రవర్తనలన్నీ
pravartiMcaTaM	ప్రవర్తించటం
prayANa	ప్రయాణ
prayOjanAlEMTi	ప్రయోజనాలేంటి
prayOjanAlEmainA	ప్రయోజనాలేమైనా
prayOjanAlU	ప్రయోజనాలూ
prayOjanAlu	ప్రయోజనాలు
prayOjanAlunnaMdunE	ప్రయోజనాలున్నందునే
prayOjanaM	ప్రయోజనం
prayOjanamU	ప్రయోజనమూ
prayatnaM	ప్రయత్నం
prayatniMcADu	ప్రయత్నించాడు
prayatnistAru	ప్రయత్నిస్తారు
priyamainavi	ప్రియమైనవి
priyanEstaM	ప్రియనేస్తం
puMjukOdu	పుంజుకోదు
puMjukuMTuMdi	పుంజుకుంటుంది
puNyaM	పుణ్యం
puNyakshEtrAllO	పుణ్యక్షేత్రాల్లో
puNyakshEtraM	పుణ్యక్షేత్రం
puNyakshEtramidi	పుణ్యక్షేత్రమిది
puNyalOka	పుణ్యలోక
puNyasnAnAlu	పుణ్యస్నానాలు
puTTa	పుట్ట
puTTalA	పుట్టలా
puTTalEdu	పుట్టలేదు
puTTaluMDEvEmO	పుట్టలుండేవేమో
puTTukoccAyi	పుట్టుకొచ్చాయి
puTTukocciMdi	పుట్టుకొచ్చింది
puTTukostuMTAyi	పుట్టుకొస్తుంటాయి
punaHpratishTha	పునఃప్రతిష్ఠ
punaHpratishThiMcinaTlu	పునఃప్రతిష్ఠించినట్లు
punaruddharaNa	పునరుద్ధరణ
punaruddhariMcADani	పునరుద్ధరించాడని
punaruddhariMcukOlEkapOvaccu	పునరుద్ధరించుకోలేకపోవచ్చు
punarutpatti	పునరుత్పత్తి
punarutpattiki	పునరుత్పత్తికి
purANAlu	పురాణాలు
purANOkti	పురాణోక్తి
purANa	పురాణ
purANaM	పురాణం
purANaMdakshayajJa	పురాణందక్షయజ్ఞ
purAtanamainadE	పురాతనమైనదే
purOgamanAnni	పురోగమనాన్ని
purOgamiMciMdi	పురోగమించింది
purOgamistunna	పురోగమిస్తున్న
purOgati	పురోగతి
purigolputuMTAyi	పురిగొల్పుతుంటాయి
purushAMga	పురుషాంగ
purushAMgaMlOki	పురుషాంగంలోకి
purushAdhikyatatO	పురుషాధిక్యతతో
purusha	పురుష
purushatvAniki	పురుషత్వానికి
purushatvaM	పురుషత్వం
purushuDiki	పురుషుడికి
purushulE	పురుషులే
purushulakE	పురుషులకే
purushullO	పురుషుల్లో
purushulu	పురుషులు
pushTiniccE	పుష్టినిచ్చే
pushkariNi	పుష్కరిణి
pushkariNigA	పుష్కరిణిగా
pushkariNiki	పుష్కరిణికి
pushkariNilO	పుష్కరిణిలో
pushkariNilOki	పుష్కరిణిలోకి
pushkariNinE	పుష్కరిణినే
pushpArcana	పుష్పార్చన
pustakAlanu	పుస్తకాలను
pustakAlatO	పుస్తకాలతో
pustakAllO	పుస్తకాల్లో
pustakAlu	పుస్తకాలు
pustakaM	పుస్తకం
putU	పుతూ
puvvulu	పువ్వులు
rALlE	రాళ్లే
rALla	రాళ్ల
rALlalO	రాళ్లలో
rALlu	రాళ్లు
rASAru	రాశారు
rAbOyE	రాబోయే
rAcapratinidhO	రాచప్రతినిధో
rAgalavanEdAnipai	రాగలవనేదానిపై
rAhityAniki	రాహిత్యానికి
rAhityamannadi	రాహిత్యమన్నది
rAjA	రాజా
rAjEMdracOLa	రాజేంద్రచోళ
rAjEMdracOLuni	రాజేంద్రచోళుని
rAja	రాజ
rAjadhAni	రాజధాని
rAjadhAnigA	రాజధానిగా
rAjagOpurAlatO	రాజగోపురాలతో
rAjagOpurAniki	రాజగోపురానికి
rAjamaMDri	రాజమండ్రి
rAjamaMDriki	రాజమండ్రికి
rAjarAjESvarI	రాజరాజేశ్వరీ
rAjarAja	రాజరాజ
rAjarAjanarEMdruDiki	రాజరాజనరేంద్రుడికి
rAjula	రాజుల
rAjulu	రాజులు
rAjyAnni	రాజ్యాన్ని
rAjyamElutunnAyi	రాజ్యమేలుతున్నాయి
rAjyavistaraNalO	రాజ్యవిస్తరణలో
rAkamuMdE	రాకముందే
rAkapOkalaku	రాకపోకలకు
rAkapOyinA	రాకపోయినా
rAkuMDA	రాకుండా
rAmaliMgESvarasvAmi	రామలింగేశ్వరస్వామి
rAnivvaddu	రానివ్వద్దు
rAsE	రాసే
rAshTrAla	రాష్ట్రాల
rAshTra	రాష్ట్ర
rAshTraMlOni	రాష్ట్రంలోని
rAsi	రాసి
rAti	రాతి
rAtiSilalanu	రాతిశిలలను
rAtigODalatO	రాతిగోడలతో
rAtimeTlu	రాతిమెట్లు
rAtrE	రాత్రే
rAtri	రాత్రి
rAtriki	రాత్రికి
rAvAli	రావాలి
rAvAlsi	రావాల్సి
rAvAlsina	రావాల్సిన
rAvEmO	రావేమో
rAvaDAniki	రావడానికి
rAvaTaM	రావటం
rAvaccO	రావచ్చో
rAvoccu	రావొచ్చు
rAyaTaM	రాయటం
rAyalavAri	రాయలవారి
rAyalavAru	రాయలవారు
rAyalu	రాయలు
rAyaluki	రాయలుకి
rAyan	రాయన్
rAyitI	రాయితీ
rAyitIpai	రాయితీపై
rAyitItO	రాయితీతో
rENiguMTa	రేణిగుంట
rENukA	రేణుకా
rENukAMbagA	రేణుకాంబగా
rENuka	రేణుక
rEgutOMdO	రేగుతోందో
rEgutunna	రేగుతున్న
rEkettiMcaTaM	రేకెత్తించటం
rEpE	రేపే
rEpaTi	రేపటి
rItilO	రీతిలో
rODDu	రోడ్డు
rOgAla	రోగాల
rOga	రోగ
rOganirOdhakaSakti	రోగనిరోధకశక్తి
rOganirOdhakavyavasthanu	రోగనిరోధకవ్యవస్థను
rOgulaku	రోగులకు
rOgulu	రోగులు
rOjU	రోజూ
rOjaMtA	రోజంతా
rOju	రోజు
rOjukArOju	రోజుకారోజు
rOjuku	రోజుకు
rOjulO	రోజులో
rOjulU	రోజులూ
rOjula	రోజుల
rOjulaku	రోజులకు
rOjulapATu	రోజులపాటు
rOjullO	రోజుల్లో
rOjulu	రోజులు
rOjuna	రోజున
rOjurOjukI	రోజురోజుకీ
rOjuvArI	రోజువారీ
rOmAlu	రోమాలు
rOnalD	రోనల్డ్
rU	రూ
rUpAllO	రూపాల్లో
rUpAyalakupainE	రూపాయలకుపైనే
rUpaMlO	రూపంలో
rUpoMdiMcAru	రూపొందించారు
rUpoMdiMci	రూపొందించి
raMDi	రండి
raMgAllO	రంగాల్లో
raMgAniki	రంగానికి
raMgaM	రంగం
raMgaMlO	రంగంలో
raMgariMci	రంగరించి
raMgulatO	రంగులతో
raSIdu	రశీదు
raSIdulanu	రశీదులను
racana	రచన
racanaku	రచనకు
racananu	రచనను
raciMcamani	రచించమని
raciMcina	రచించిన
raddI	రద్దీ
raddIni	రద్దీని
raddu	రద్దు
rahadAri	రహదారి
rahadArilO	రహదారిలో
rahita	రహిత
railu	రైలు
railvEsTEshan	రైల్వేస్టేషన్
raitu	రైతు
rajata	రజత
rakAla	రకాల
rakAlanu	రకాలను
rakAnni	రకాన్ని
rakaM	రకం
rakaMgAnU	రకంగానూ
rakarakAla	రకరకాల
rakshaNa	రక్షణ
rakshakuDini	రక్షకుడిని
rakta	రక్త
raktaM	రక్తం
raktaMlO	రక్తంలో
raktapOTu	రక్తపోటు
raktaprasAraM	రక్తప్రసారం
raktaprasaraNa	రక్తప్రసరణ
rammani	రమ్మని
rathOtsavAnni	రథోత్సవాన్ని
ravANA	రవాణా
ravvalu	రవ్వలు
reDDi	రెడ్డి
reMDELla	రెండేళ్ల
reMDO	రెండో
reMDOdi	రెండోది
reMDOsAri	రెండోసారి
reMDOvyakti	రెండోవ్యక్తి
reMDU	రెండూ
reMDiMTikI	రెండింటికీ
reMDu	రెండు
reMTikI	రెంటికీ
reMTinI	రెంటినీ
reMTipainA	రెంటిపైనా
reTInA	రెటీనా
reppalA	రెప్పలా
rijarv	రిజర్వ్
rijarvEshan	రిజర్వేషన్
rijiskAn	రిజిస్కాన్
rilayans	రిలయన్స్
ripOrTulu	రిపోర్టులు
riyO	రియో
rommu	రొమ్ము
rommulu	రొమ్ములు
ruculanu	రుచులను
rudrAbhishEkaM	రుద్రాభిషేకం
rudra	రుద్ర
rudramUrtini	రుద్రమూర్తిని
rudravaraM	రుద్రవరం
rugmatalakU	రుగ్మతలకూ
rujuvu	రుజువు
rushi	రుషి
rushulu	రుషులు
rushyaSRMga	రుష్యశృంగ
rusuM	రుసుం
rusumu	రుసుము
rutukramaM	రుతుక్రమం
rutusrAvaM	రుతుస్రావం
ryAMku	ర్యాంకు
ryAMkulO	ర్యాంకులో
ryAMkulU	ర్యాంకులూ
sALuva	సాళువ
sAMbaSivuDu	సాంబశివుడు
sAMbaSivuNNi	సాంబశివుణ్ణి
sATirAgala	సాటిరాగల
sAdhAraNa	సాధారణ
sAdhAraNaMgA	సాధారణంగా
sAdhanAlu	సాధనాలు
sAdhana	సాధన
sAdhanaM	సాధనం
sAdhanaceyyaTaM	సాధనచెయ్యటం
sAdhanaku	సాధనకు
sAdhiMcEMduku	సాధించేందుకు
sAdhiMcaTAniki	సాధించటానికి
sAdhiMcagalugutAmanaDaMlO	సాధించగలుగుతామనడంలో
sAdhiMcalEnivAraMtA	సాధించలేనివారంతా
sAdhiMciMdi	సాధించింది
sAdhiMcinappuDE	సాధించినప్పుడే
sAdhyaM	సాధ్యం
sAdhyamainaMta	సాధ్యమైనంత
sAdhyamavutuMdi	సాధ్యమవుతుంది
sAgaTAniki	సాగటానికి
sAgakUDadu	సాగకూడదు
sAgani	సాగని
sAgavaccu	సాగవచ్చు
sAgiMcAli	సాగించాలి
sAgiMcE	సాగించే
sAgipOtOMdani	సాగిపోతోందని
sAgipOtunna	సాగిపోతున్న
sAgutAyi	సాగుతాయి
sAgutOMdi	సాగుతోంది
sAgutUnE	సాగుతూనే
sAgutuMTuMdigAnI	సాగుతుంటుందిగానీ
sAgutunna	సాగుతున్న
sAhasAlaku	సాహసాలకు
sAhitI	సాహితీ
sAkshAtkArAlicci	సాక్షాత్కారాలిచ్చి
sAkshAtkariMcADani	సాక్షాత్కరించాడని
sAkshAtkariMci	సాక్షాత్కరించి
sAkshAttU	సాక్షాత్తూ
sAlagrAmaSila	సాలగ్రామశిల
sAmAjika	సామాజిక
sAmAjikamaina	సామాజికమైన
sAmardhya	సామర్ధ్య
sAmardhyaM	సామర్ధ్యం
sAmarlakOTalO	సామర్లకోటలో
sAmarthya	సామర్థ్య
sAmarthyaM	సామర్థ్యం
sAmarthyaMtO	సామర్థ్యంతో
sAmarthyamU	సామర్థ్యమూ
sAmavai	సామవై
sAmrAjyAdhISulu	సామ్రాజ్యాధీశులు
sAmrAjya	సామ్రాజ్య
sAnnihityAnni	సాన్నిహిత్యాన్ని
sAnnihitya	సాన్నిహిత్య
sAnnihityaM	సాన్నిహిత్యం
sAnukUla	సానుకూల
sAphIgA	సాఫీగా
sArlu	సార్లు
sArvabhaumuDugA	సార్వభౌముడుగా
sAyaM	సాయం
sAyaMtO	సాయంతో
sAyaMtraM	సాయంత్రం
sAyaMtraMlOpu	సాయంత్రంలోపు
sEkariMcI	సేకరించీ
sEpu	సేపు
sEtubaMdha	సేతుబంధ
sEvA	సేవా
sEva	సేవ
sEvalO	సేవలో
sEvala	సేవల
sEvalanu	సేవలను
sEvalu	సేవలు
sITu	సీటు
sIes	సీఎస్
sIvOpIDI	సీవోపీడీ
sOmESvara	సోమేశ్వర
sOmESvaraM	సోమేశ్వరం
sOmavAraM	సోమవారం
sRshTiMci	సృష్టించి
sRshTiki	సృష్టికి
sRshTilOni	సృష్టిలోని
sRshTistuMdi	సృష్టిస్తుంది
sTAk	స్టాక్
sTET	స్టేట్
sTEshan	స్టేషన్
sTep	స్టెప్
sUcistAyi	సూచిస్తాయి
sUcistE	సూచిస్తే
sUcistuMdi	సూచిస్తుంది
sUcistunnAru	సూచిస్తున్నారు
sUkshmaSarIrAnni	సూక్ష్మశరీరాన్ని
sUpar	సూపర్
sUrya	సూర్య
sUryabhagavAnuDu	సూర్యభగవానుడు
sUryuDi	సూర్యుడి
sUryuDu	సూర్యుడు
sUtrAlu	సూత్రాలు
sUtrIkaraNalaku	సూత్రీకరణలకు
sUtradhAri	సూత్రధారి
saMbOdhistU	సంబోధిస్తూ
saMbaMdhAlanu	సంబంధాలను
saMbaMdhAllOnE	సంబంధాల్లోనే
saMbaMdhAlu	సంబంధాలు
saMbaMdha	సంబంధ
saMbaMdhaM	సంబంధం
saMbaMdhaMlO	సంబంధంలో
saMbaMdhiMci	సంబంధించి
saMbaMdhiMcina	సంబంధించిన
saMbaMdhiMcinadE	సంబంధించినదే
saMbaMdhiMcinavE	సంబంధించినవే
saMbaMdhita	సంబంధిత
saMbhOgAnni	సంభోగాన్ని
saMbhOgaM	సంభోగం
saMbhOgaMlO	సంభోగంలో
saMbhOgamE	సంభోగమే
saMcalanaM	సంచలనం
saMcaristADu	సంచరిస్తాడు
saMcaristuMTADu	సంచరిస్తుంటాడు
saMdEhaM	సందేహం
saMdaDE	సందడే
saMdarSiMcEMduku	సందర్శించేందుకు
saMdarSistE	సందర్శిస్తే
saMdarbhAllO	సందర్భాల్లో
saMdarbhAnusAraM	సందర్భానుసారం
saMdarbhaMlO	సందర్భంలో
saMdarbhamidi	సందర్భమిది
saMdhyAvaMdana	సంధ్యావందన
saMgamaMgA	సంగమంగా
saMgati	సంగతి
saMgatini	సంగతిని
saMghaTanalennO	సంఘటనలెన్నో
saMhariMcina	సంహరించిన
saMkOciMci	సంకోచించి
saMkalpaM	సంకల్పం
saMkalpabalaMtO	సంకల్పబలంతో
saMkalpita	సంకల్పిత
saMkhya	సంఖ్య
saMkhyalO	సంఖ్యలో
saMkhyanu	సంఖ్యను
saMkucita	సంకుచిత
saMpUrNa	సంపూర్ణ
saMpUrNamaina	సంపూర్ణమైన
saMpUrNatvaM	సంపూర్ణత్వం
saMpradAyAla	సంప్రదాయాల
saMpradAyAniki	సంప్రదాయానికి
saMpradAya	సంప్రదాయ
saMpradAyaMlO	సంప్రదాయంలో
saMpradiMcAli	సంప్రదించాలి
saMpradiMcaTaM	సంప్రదించటం
saMpradiMcavaccu	సంప్రదించవచ్చు
saMpradistuMTAru	సంప్రదిస్తుంటారు
saMrakshaNa	సంరక్షణ
saMsiddhaM	సంసిద్ధం
saMsiddhamavutuMTAM	సంసిద్ధమవుతుంటాం
saMsiddhatE	సంసిద్ధతే
saMsiddhata	సంసిద్ధత
saMsiddhulanu	సంసిద్ధులను
saMskRta	సంస్కృత
saMskRtaMlO	సంస్కృతంలో
saMskRtilO	సంస్కృతిలో
saMskRtulatO	సంస్కృతులతో
saMskRtulu	సంస్కృతులు
saMsthAnAdhISuDi	సంస్థానాధీశుడి
saMstha	సంస్థ
saMsthalO	సంస్థలో
saMsthala	సంస్థల
saMsthalatO	సంస్థలతో
saMsthallO	సంస్థల్లో
saMsthalu	సంస్థలు
saMsthanu	సంస్థను
saMtAnAnni	సంతానాన్ని
saMtAnAsaktitOnE	సంతానాసక్తితోనే
saMtAna	సంతాన
saMtAnaM	సంతానం
saMtOshAniki	సంతోషానికి
saMtOshaMgAnE	సంతోషంగానే
saMtOshapaDEvAru	సంతోషపడేవారు
saMtRptigAnE	సంతృప్తిగానే
saMtariMcukoMdi	సంతరించుకొంది
saMtati	సంతతి
saMvatsarAla	సంవత్సరాల
saMvatsarAniki	సంవత్సరానికి
saMvatsarOtsavAlanu	సంవత్సరోత్సవాలను
saMvatsaraMlO	సంవత్సరంలో
saSAstrIyaMgA	సశాస్త్రీయంగా
sabIhA	సబీహా
sabhAvEdikanu	సభావేదికను
sabhyula	సభ్యుల
sacitraMgA	సచిత్రంగా
sadupAyAlu	సదుపాయాలు
sadupAyAnni	సదుపాయాన్ని
sadupAyaM	సదుపాయం
sadviniyOgaM	సద్వినియోగం
sagAniki	సగానికి
sagaM	సగం
sagaTu	సగటు
sagaTuna	సగటున
sahA	సహా
sahAyaM	సహాయం
sahAyakulanu	సహాయకులను
sahAyapaDAli	సహాయపడాలి
sahajAtaM	సహజాతం
sahajAtaMgA	సహజాతంగా
sahajAtamEgAnI	సహజాతమేగానీ
sahaja	సహజ
sahajaM	సహజం
sahajaMgA	సహజంగా
sahajaMgAnE	సహజంగానే
sahajamaina	సహజమైన
sahajamani	సహజమని
sahakariMcE	సహకరించే
sahakariMcEvanna	సహకరించేవన్న
sahakaristuMdi	సహకరిస్తుంది
sahasrAbdAlaku	సహస్రాబ్దాలకు
sahasraliMgESvaruDu	సహస్రలింగేశ్వరుడు
saiTlu	సైట్లు
saigalu	సైగలు
saikAlajI	సైకాలజీ
saikliMg	సైక్లింగ్
sains	సైన్స్
sainyaMlO	సైన్యంలో
saitaM	సైతం
sajAvugA	సజావుగా
sakala	సకల
sakalatIrthAlU	సకలతీర్థాలూ
salIM	సలీం
salahA	సలహా
salahAlU	సలహాలూ
salahAlu	సలహాలు
salahAtOnE	సలహాతోనే
samAcArAnnE	సమాచారాన్నే
samAcArAnni	సమాచారాన్ని
samAcAraM	సమాచారం
samAdhAnaM	సమాధానం
samAjAniki	సమాజానికి
samAjaM	సమాజం
samAjaMlO	సమాజంలో
samAjamU	సమాజమూ
samAnamaina	సమానమైన
samEta	సమేత
samEtaMgA	సమేతంగా
samEtuDaina	సమేతుడైన
samIpaM	సమీపం
samIpaMlOni	సమీపంలోని
samIpaMlOnunna	సమీపంలోనున్న
samO	సమో
samaM	సమం
samadhikOtsAhaMtO	సమధికోత్సాహంతో
samagra	సమగ్ర
samagrata	సమగ్రత
samakUrcutAru	సమకూర్చుతారు
samarpiMcAli	సమర్పించాలి
samarpiMcE	సమర్పించే
samartha	సమర్థ
samarthaMgA	సమర్థంగా
samarthamaina	సమర్థమైన
samarthataku	సమర్థతకు
samasipOkapOvaccugAnI	సమసిపోకపోవచ్చుగానీ
samasta	సమస్త
samasyE	సమస్యే
samasya	సమస్య
samasyagA	సమస్యగా
samasyaku	సమస్యకు
samasyalU	సమస్యలూ
samasyala	సమస్యల
samasyalaku	సమస్యలకు
samasyalannI	సమస్యలన్నీ
samasyalanu	సమస్యలను
samasyalatO	సమస్యలతో
samasyallO	సమస్యల్లో
samasyalni	సమస్యల్ని
samasyalu	సమస్యలు
samasyaluMTE	సమస్యలుంటే
samasyaluMTunnaTTu	సమస్యలుంటున్నట్టు
samasyalunna	సమస్యలున్న
samasyanu	సమస్యను
samasyatO	సమస్యతో
samatalaMgA	సమతలంగా
samataulyaMlOki	సమతౌల్యంలోకి
samatulyatanu	సమతుల్యతను
samayAla	సమయాల
samayAlanu	సమయాలను
samayAllOnE	సమయాల్లోనే
samayAniki	సమయానికి
samayAnni	సమయాన్ని
samayaM	సమయం
samayaMlO	సమయంలో
samayaMlOpu	సమయంలోపు
sammatiMcaDaMtO	సమ్మతించడంతో
samudAyaMlO	సముదాయంలో
sanAtana	సనాతన
sannaTi	సన్నటి
sannaddhaM	సన్నద్ధం
sannaddhata	సన్నద్ధత
sannagillinA	సన్నగిల్లినా
sannagillipOvaTamannadi	సన్నగిల్లిపోవటమన్నది
sannidhiki	సన్నిధికి
sannidhilO	సన్నిధిలో
sannihitaMgA	సన్నిహితంగా
sapta	సప్త
saptagOdAvari	సప్తగోదావరి
saptagOdAvarigA	సప్తగోదావరిగా
saptagOdAvarini	సప్తగోదావరిని
saptagirISuDani	సప్తగిరీశుడని
saptamAtRkalu	సప్తమాతృకలు
saptarshulanu	సప్తర్షులను
saptarshulu	సప్తర్షులు
saptarushulu	సప్తరుషులు
sarE	సరే
saraLaMgA	సరళంగా
saradA	సరదా
saraina	సరైన
sarapharAku	సరఫరాకు
sardEsukoni	సర్దేసుకొని
sardukuni	సర్దుకుని
sarididdE	సరిదిద్దే
sarigA	సరిగా
sariggA	సరిగ్గా
sarikotta	సరికొత్త
saripOdEmO	సరిపోదేమో
saripOdu	సరిపోదు
saripOru	సరిపోరు
saripOtOMdA	సరిపోతోందా
saripOtuMdi	సరిపోతుంది
sarisamAnaMgA	సరిసమానంగా
sarjan	సర్జన్
sarvAMgAsanaM	సర్వాంగాసనం
sarvE	సర్వే
sarvElO	సర్వేలో
sarvEnu	సర్వేను
sarvIsu	సర్వీసు
sarvIsulatO	సర్వీసులతో
sarvIsulu	సర్వీసులు
sarva	సర్వ
sarvapApAlnI	సర్వపాపాల్నీ
sarvasAdhAraNaM	సర్వసాధారణం
sarvasAdhAraNamavutunnAyi	సర్వసాధారణమవుతున్నాయి
sarvatrA	సర్వత్రా
satI	సతీ
satIdEvi	సతీదేవి
satIdEviki	సతీదేవికి
satamataM	సతమతం
satamatamavutunna	సతమతమవుతున్న
satiki	సతికి
satrAlni	సత్రాల్ని
satsaMbaMdhAlu	సత్సంబంధాలు
saukaryAlu	సౌకర్యాలు
saukaryaM	సౌకర్యం
saukaryaMgA	సౌకర్యంగా
saukaryamU	సౌకర్యమూ
saukaryamuMdi	సౌకర్యముంది
saukhyaM	సౌఖ్యం
saulabhyaM	సౌలభ్యం
saurAshTra	సౌరాష్ట్ర
savALLanu	సవాళ్ళను
savariMcukuMTU	సవరించుకుంటూ
seks	సెక్స్
seksu	సెక్సు
seksuval	సెక్సువల్
selavoccinA	సెలవొచ్చినా
selayELlu	సెలయేళ్లు
seraTOnin	సెరటోనిన్
sevvusAni	సెవ్వుసాని
shAk	షాక్
shErla	షేర్ల
shErlaku	షేర్లకు
shErlanu	షేర్లను
shErlu	షేర్లు
shaTlar	షట్లర్
sharatu	షరతు
si	సి
siMdhu	సింధు
siMdhuku	సింధుకు
siMhaM	సింహం
siMharUpuDaina	సింహరూపుడైన
siddhAMtAlannI	సిద్ధాంతాలన్నీ
siddhAMtAlatO	సిద్ధాంతాలతో
siddhAMtAniki	సిద్ధాంతానికి
siddhAMtIkariMcAru	సిద్ధాంతీకరించారు
siddhaM	సిద్ధం
siddhamaiMdi	సిద్ధమైంది
siddhamavutAru	సిద్ధమవుతారు
siddhamavutuMDE	సిద్ధమవుతుండే
siddhamayyAru	సిద్ధమయ్యారు
siddhiMcE	సిద్ధించే
siddhistunnAyani	సిద్ధిస్తున్నాయని
siggupaDAlsina	సిగ్గుపడాల్సిన
siggupaDE	సిగ్గుపడే
sigmaMD	సిగ్మండ్
sikiMdrAbAd	సికింద్రాబాద్
silabas	సిలబస్
sinimAlanu	సినిమాలను
sinimAllOlA	సినిమాల్లోలా
siphArsu	సిఫార్సు
siralu	సిరలు
sirikikolanu	సిరికికొలను
sirikolanu	సిరికొలను
sitO	సితో
skAMdapurANaM	స్కాందపురాణం
skULlalO	స్కూళ్లలో
skUl	స్కూల్
skUllOnO	స్కూల్లోనో
skUllOnU	స్కూల్లోనూ
skUlu	స్కూలు
slekarOsis	స్లె్కరోసిస్
snAnaM	స్నానం
snAnamADE	స్నానమాడే
snAnamAcariMci	స్నానమాచరించి
snAnamAcariMcina	స్నానమాచరించిన
snAnamAcaristE	స్నానమాచరిస్తే
snAyuvula	స్నాయువుల
snEhitula	స్నేహితుల
snEhitulatO	స్నేహితులతో
soMta	సొంత
soMtaM	సొంతం
soMtamaiMdanI	సొంతమైందనీ
spRSiMcaTaM	స్పృశించటం
spRSiMci	స్పృశించి
spaMdanala	స్పందనల
spashTaMgA	స్పష్టంగా
spashTamaina	స్పష్టమైన
sphUrti	స్ఫూర్తి
sphaTika	స్ఫటిక
srAvaM	స్రావం
sravaMtilOki	స్రవంతిలోకి
staMbhAla	స్తంభాల
staMbhAlapaina	స్తంభాలపైన
staMbhana	స్తంభన
staMbhanalu	స్తంభనలు
staMbhistuMdanna	స్తంభిస్తుందన్న
staMbhistuMdi	స్తంభిస్తుంది
sthAnAnni	స్థానాన్ని
sthAnaM	స్థానం
sthAnika	స్థానిక
sthApiMcAraTa	స్థాపించారట
sthAyi	స్థాయి
sthAyilO	స్థాయిలో
sthAyini	స్థాయిని
sthAyulu	స్థాయులు
sthOmata	స్థోమత
sthUlaMgA	స్థూలంగా
sthala	స్థల
sthalaM	స్థలం
sthalapurANaM	స్థలపురాణం
sthalapurANaMlO	స్థలపురాణంలో
sthimitaMgA	స్థిమితంగా
sthiraMgA	స్థిరంగా
sthiramaina	స్థిరమైన
sthirapaDiMdani	స్థిరపడిందని
sthirapaDipOyiMdi	స్థిరపడిపోయింది
sthiti	స్థితి
sthitilOki	స్థితిలోకి
sthitini	స్థితిని
strIhArmOnlugA	స్త్రీహార్మోన్లుగా
strIla	స్త్రీల
strIlaMdarilAgE	స్త్రీలందరిలాగే
strIlakU	స్త్రీలకూ
strIlakaMTE	స్త్రీలకంటే
strIlalO	స్త్రీలలో
strIlanE	స్త్రీలనే
strIlu	స్త్రీలు
strIpurusha	స్త్రీపురుష
strIpurushula	స్త్రీపురుషుల
strIpurushulu	స్త్రీపురుషులు
strIsvEcCA	స్త్రీస్వేచ్ఛా
suMdara	సుందర
subEdArO	సుబేదారో
subrahmaNyESvarasvAmi	సుబ్రహ్మణ్యేశ్వరస్వామి
subrahmaNyESvaruDu	సుబ్రహ్మణ్యేశ్వరుడు
sudIrgha	సుదీర్ఘ
sudIrghamaina	సుదీర్ఘమైన
sudarSana	సుదర్శన
suddamukkala	సుద్దముక్కల
sudhAkar	సుధాకర్
sukhIbhava	సుఖీభవ
sukhaM	సుఖం
sukhapradaM	సుఖప్రదం
sulabhaM	సులభం
sulabhamaina	సులభమైన
suluvugA	సులువుగా
sumAru	సుమారు
sumaMt	సుమంత్
sumanOhara	సుమనోహర
sunnitaMgA	సున్నితంగా
sunnitamaina	సున్నితమైన
suprasiddhurAlaiMdi	సుప్రసిద్ధురాలైంది
supta	సుప్త
surESvara	సురేశ్వర
surakshita	సురక్షిత
suvarNa	సువర్ణ
svAmi	స్వామి
svAmigA	స్వామిగా
svAmiki	స్వామికి
svAmini	స్వామిని
svAmitOpATu	స్వామితోపాటు
svAmivAri	స్వామివారి
svAmivAriki	స్వామివారికి
svAmivAru	స్వామివారు
svAmula	స్వాముల
svAti	స్వాతి
svIDan	స్వీడన్
svIkariMcavaccu	స్వీకరించవచ్చు
svIkaristADu	స్వీకరిస్తాడు
svIkaristAru	స్వీకరిస్తారు
svIkaristuMdi	స్వీకరిస్తుంది
svabhAvaMtO	స్వభావంతో
svacCaMda	స్వచ్ఛంద
svadESAniki	స్వదేశానికి
svapna	స్వప్న
svapnaMlO	స్వప్నంలో
svarUpaMlO	స్వరూపంలో
svasthata	స్వస్థత
svayaM	స్వయం
svayaMbhUgA	స్వయంభూగా
svayaMbhUliMgAnni	స్వయంభూలింగాన్ని
svayaMbhUmUrti	స్వయంభూమూర్తి
svayaMbhu	స్వయంభు
svayaMbhuvuDaina	స్వయంభువుడైన
svayaMbhuvuDayyADani	స్వయంభువుడయ్యాడని
svayaMbhuvugA	స్వయంభువుగా
svayaMbhuvunu	స్వయంభువును
svayaMgA	స్వయంగా
tAMDavaM	తాండవం
tAgoccu	తాగొచ్చు
tAjAgA	తాజాగా
tAkaTaM	తాకటం
tAkalEvu	తాకలేవు
tAkinaTlugAnE	తాకినట్లుగానే
tAmU	తామూ
tAmara	తామర
tAmu	తాము
tApIgA	తాపీగా
tArkANaM	తార్కాణం
tAvulEni	తావులేని
tEDA	తేడా
tEDAgA	తేడాగా
tEDAlocci	తేడాలొచ్చి
tEDAluMDoccu	తేడాలుండొచ్చు
tElaTaM	తేలటం
tElcAru	తేల్చారు
tElcESADaTa	తేల్చేశాడట
tElcukunnappuDE	తేల్చుకున్నప్పుడే
tEliMdi	తేలింది
tElika	తేలిక
tElikagA	తేలికగా
tElikapATi	తేలికపాటి
tEvaTaMlO	తేవటంలో
tIrAna	తీరాన
tIraTAniki	తీరటానికి
tIrcE	తీర్చే
tIrci	తీర్చి
tIrcididdAru	తీర్చిదిద్దారు
tIrcididdAyi	తీర్చిదిద్దాయి
tIrcididdutuMdi	తీర్చిదిద్దుతుంది
tIrcukoni	తీర్చుకొని
tIrpulu	తీర్పులు
tIrthAniki	తీర్థానికి
tIrthAnni	తీర్థాన్ని
tIrthaM	తీర్థం
tIrthaMgAnE	తీర్థంగానే
tIrthaMlO	తీర్థంలో
tIrthamanI	తీర్థమనీ
tIrtharAjaM	తీర్థరాజం
tIrtharAjamE	తీర్థరాజమే
tIru	తీరు
tIrulO	తీరులో
tIsEstunnAranukuMdAM	తీసేస్తున్నారనుకుందాం
tIsEyistuMTAru	తీసేయిస్తుంటారు
tIsai	తీసై
tIsi	తీసి
tIstuMdi	తీస్తుంది
tIsukOkapOtE	తీసుకోకపోతే
tIsukOvAli	తీసుకోవాలి
tIsukOvAlsi	తీసుకోవాల్సి
tIsukOvAlsina	తీసుకోవాల్సిన
tIsukOvaTAnni	తీసుకోవటాన్ని
tIsukOvaTaM	తీసుకోవటం
tIsukOvaTaMlO	తీసుకోవటంలో
tIsukOvaccu	తీసుకోవచ్చు
tIsukeLitE	తీసుకెళితే
tIsukeLlE	తీసుకెళ్లే
tIsukeLlaMDi	తీసుకెళ్లండి
tIsukoccADu	తీసుకొచ్చాడు
tIsukocci	తీసుకొచ్చి
tIsukostAyi	తీసుకొస్తాయి
tIsuku	తీసుకు
tIsukuMTAru	తీసుకుంటారు
tIsukuMTE	తీసుకుంటే
tIsukuMTU	తీసుకుంటూ
tIsukuMTuMTAru	తీసుకుంటుంటారు
tIsukunE	తీసుకునే
tIsukunEvALlu	తీసుకునేవాళ్లు
tIsukunnAru	తీసుకున్నారు
tIsukunna	తీసుకున్న
tIsukuvaccArani	తీసుకువచ్చారని
tIsukuvacci	తీసుకువచ్చి
tIsukuvacciMdi	తీసుకువచ్చింది
tIvra	తీవ్ర
tIvraMgA	తీవ్రంగా
tIvramaina	తీవ్రమైన
tIvrata	తీవ్రత
tO	తో
tODpaDEdE	తోడ్పడేదే
tODpaDatAyi	తోడ్పడతాయి
tODpaDitE	తోడ్పడితే
tODpaDutuMdi	తోడ్పడుతుంది
tODu	తోడు
tODugA	తోడుగా
tOTa	తోట
tOTi	తోటి
tObuTTuvula	తోబుట్టువుల
tOkatO	తోకతో
tOmukoni	తోముకొని
tOvalO	తోవలో
tRpti	తృప్తి
tRptikI	తృప్తికీ
tRptinI	తృప్తినీ
tRptini	తృప్తిని
tRtIya	తృతీయ
tUrpu	తూర్పు
tUrpucALukyula	తూర్పుచాళుక్యుల
tUrpugOdAvari	తూర్పుగోదావరి
tUrpumukhaMgA	తూర్పుముఖంగా
tUrpuna	తూర్పున
tUtUmaMtraMgA	తూతూమంత్రంగా
taDabaDutUnE	తడబడుతూనే
taMDri	తండ్రి
taMtugA	తంతుగా
taMtugAnE	తంతుగానే
taTTukuni	తట్టుకుని
taditara	తదితర
tagadani	తగదని
tagadu	తగదు
tagavunu	తగవును
taggAyA	తగ్గాయా
taggAyannadi	తగ్గాయన్నది
taggE	తగ్గే
taggEMduku	తగ్గేందుకు
taggaTAniki	తగ్గటానికి
taggaTTugA	తగ్గట్టుగా
taggaTaM	తగ్గటం
taggadu	తగ్గదు
taggiMcEMduku	తగ్గించేందుకు
taggiMcukOvaTAnikI	తగ్గించుకోవటానికీ
taggiMdA	తగ్గిందా
taggina	తగ్గిన
tagginaTTu	తగ్గినట్టు
taggipOtAyi	తగ్గిపోతాయి
taggipOtE	తగ్గిపోతే
taggipOtOMdani	తగ్గిపోతోందని
taggipOtuMTE	తగ్గిపోతుంటే
taggipOtuMdEmOnanna	తగ్గిపోతుందేమోనన్న
taggipOvaTAniki	తగ్గిపోవటానికి
taggipOvaTAnni	తగ్గిపోవటాన్ని
taggipOvaTaM	తగ్గిపోవటం
taggipOvaTamannadi	తగ్గిపోవటమన్నది
taggipOvaccu	తగ్గిపోవచ్చు
taggistuMdi	తగ్గిస్తుంది
taggutAyannadi	తగ్గుతాయన్నది
taggutAyi	తగ్గుతాయి
taggutuMTAyi	తగ్గుతుంటాయి
taggutuMdi	తగ్గుతుంది
taggutunnaTTanipistE	తగ్గుతున్నట్టనిపిస్తే
tagina	తగిన
taginaMta	తగినంత
takkuva	తక్కువ
takkuvagA	తక్కువగా
takkuvalainA	తక్కువలైనా
takkuvanI	తక్కువనీ
talOcEyI	తలోచేయీ
tala	తల
talakiMdulugA	తలకిందులుగా
talanIlAlu	తలనీలాలు
talapOSAru	తలపోశారు
talapeTTi	తలపెట్టి
talapistuMdi	తలపిస్తుంది
talcukuMTEnE	తల్చుకుంటేనే
talettE	తలెత్తే
talettinA	తలెత్తినా
talettina	తలెత్తిన
talettoccu	తలెత్తొచ్చు
talettuku	తలెత్తుకు
talettutU	తలెత్తుతూ
talli	తల్లి
tallidaMDrulI	తల్లిదండ్రులీ
tallidaMDrulU	తల్లిదండ్రులూ
tallidaMDrula	తల్లిదండ్రుల
tallidaMDrulu	తల్లిదండ్రులు
tallidaMDrulugA	తల్లిదండ్రులుగా
tallini	తల్లిని
tallitaMDrulu	తల్లితండ్రులు
talupulu	తలుపులు
tama	తమ
tamakEdO	తమకేదో
tamakaMTE	తమకంటే
tamaku	తమకు
tamalO	తమలో
tamiLaMlO	తమిళంలో
tana	తన
tanaTeLlagAnE	తనటెళ్లగానే
tanaki	తనకి
tanakishTaM	తనకిష్టం
tanaku	తనకు
tanalO	తనలో
tanani	తనని
tananu	తనను
tanikhIlu	తనిఖీలు
tanmayaMgA	తన్మయంగా
tanuvu	తనువు
tapAlA	తపాలా
tapassu	తపస్సు
tapassuki	తపస్సుకి
tapassuku	తపస్సుకు
tapassutO	తపస్సుతో
tappE	తప్పే
tappEmI	తప్పేమీ
tappa	తప్ప
tappadu	తప్పదు
tappakuMDA	తప్పకుండా
tappani	తప్పని
tappanisari	తప్పనిసరి
tappanisarigA	తప్పనిసరిగా
tappiMci	తప్పించి
tappidaM	తప్పిదం
tappistunnAyi	తప్పిస్తున్నాయి
tappu	తప్పు
tappuDu	తప్పుడు
tappugA	తప్పుగా
tapputOMdA	తప్పుతోందా
tarAla	తరాల
tarAniki	తరానికి
taraMgiNi	తరంగిణి
tarabaDi	తరబడి
taracU	తరచూ
taracudanaM	తరచుదనం
taragati	తరగతి
tarali	తరలి
taraliMcAlani	తరలించాలని
taralivaccE	తరలివచ్చే
taratarAlugA	తరతరాలుగా
taravAta	తరవాత
tarigoMDa	తరిగొండ
taristunnAru	తరిస్తున్నారు
taruNaM	తరుణం
taruNaMlO	తరుణంలో
taruvAta	తరువాత
tarvAtE	తర్వాతే
tarvAta	తర్వాత
tarvAtagAnI	తర్వాతగానీ
tarvAti	తర్వాతి
tarvAttarvAti	తర్వాత్తర్వాతి
tavvakAlu	తవ్వకాలు
tavvutU	తవ్వుతూ
tayArI	తయారీ
tayArIlO	తయారీలో
tayArainappuDu	తయారైనప్పుడు
tayAravutAyi	తయారవుతాయి
tayAravutOMdi	తయారవుతోంది
tayAravutuMTAru	తయారవుతుంటారు
tayAravutuMdi	తయారవుతుంది
tayArayyE	తయారయ్యే
tayAru	తయారు
teccAru	తెచ్చారు
teccAyi	తెచ్చాయి
teccE	తెచ్చే
teccEdE	తెచ్చేదే
teccElOpE	తెచ్చేలోపే
tecci	తెచ్చి
teccipeTTukunnadi	తెచ్చిపెట్టుకున్నది
teccukOvAlani	తెచ్చుకోవాలని
teccukOvaDaM	తెచ్చుకోవడం
teccukuMTE	తెచ్చుకుంటే
telIni	తెలీని
telaMgANa	తెలంగాణ
telipE	తెలిపే
telipina	తెలిపిన
telisElA	తెలిసేలా
telisi	తెలిసి
telisiMdE	తెలిసిందే
telisiMdi	తెలిసింది
telivitETalu	తెలివితేటలు
teliyAli	తెలియాలి
teliyadu	తెలియదు
teliyajEstADu	తెలియజేస్తాడు
teliyaka	తెలియక
teliyakuMDA	తెలియకుండా
tellaTi	తెల్లటి
tellavArujAmuna	తెల్లవారుజామున
telugu	తెలుగు
telugunATa	తెలుగునాట
telugusIma	తెలుగుసీమ
teluguvAri	తెలుగువారి
telupu	తెలుపు
telupulanu	తెలుపులను
telustOMdi	తెలుస్తోంది
telusu	తెలుసు
telusukOgaligina	తెలుసుకోగలిగిన
telusukOvAli	తెలుసుకోవాలి
telusukOvaTaM	తెలుసుకోవటం
telusukOvaTaMlO	తెలుసుకోవటంలో
telusukOvaccu	తెలుసుకోవచ్చు
telusukoni	తెలుసుకొని
telusukunEMduku	తెలుసుకునేందుకు
telusukuni	తెలుసుకుని
teppOtsavAlU	తెప్పోత్సవాలూ
teppiMcADu	తెప్పించాడు
tera	తెర
terallOMcI	తెరల్లోంచీ
terici	తెరిచి
terustAru	తెరుస్తారు
testOMdi	తెస్తోంది
testU	తెస్తూ
testunnAru	తెస్తున్నారు
thOraNi	థోరణి
thrillu	థ్రిల్లు
timmappa	తిమ్మప్ప
tini	తిని
tiragalEka	తిరగలేక
tiraskaristADu	తిరస్కరిస్తాడు
tirigeLlipOyAM	తిరిగెళ్లిపోయాం
tirigi	తిరిగి
tirigirAvaDaM	తిరిగిరావడం
tiru	తిరు
tirucuTTumAlika	తిరుచుట్టుమాలిక
tirugutunnaTTu	తిరుగుతున్నట్టు
tirugutunnaTTuMDE	తిరుగుతున్నట్టుండే
tirumala	తిరుమల
tirumalagiripai	తిరుమలగిరిపై
tirumalagirulalO	తిరుమలగిరులలో
tirumalaku	తిరుమలకు
tirumalalO	తిరుమలలో
tirumalappa	తిరుమలప్ప
tirumalarAyalu	తిరుమలరాయలు
tirunALla	తిరునాళ్ల
tirupati	తిరుపతి
tirupatiki	తిరుపతికి
tirupatilO	తిరుపతిలో
titidE	తితిదే
titidEyE	తితిదేయే
tivAcI	తివాచీ
toMDamAn	తొండమాన్
toMbhaiSAtaM	తొంభైశాతం
toMdarapATu	తొందరపాటు
toMdarlO	తొందర్లో
toTTatoli	తొట్టతొలి
toTTatoligA	తొట్టతొలిగా
tokkutunnappuDu	తొక్కుతున్నప్పుడు
tolagiMci	తొలగించి
tolagiMcukuMTEnE	తొలగించుకుంటేనే
tolagipOtAyani	తొలగిపోతాయని
tolagipOyi	తొలగిపోయి
toli	తొలి
toluta	తొలుత
trEnpulu	త్రేన్పులు
trEtAyugaMlO	త్రేతాయుగంలో
trayaMga	త్రయంగ
tridaMDi	త్రిదండి
triliMga	త్రిలింగ
tripurAsuruNNi	త్రిపురాసురుణ్ణి
tu	తు
tuDicEsi	తుడిచేసి
tuDiciMdi	తుడిచింది
tulasi	తులసి
tulyuDanE	తుల్యుడనే
tummulu	తుమ్ములు
tuphAnu	తుఫాను
tvaragA	త్వరగా
tvaralO	త్వరలో
tvaratvaragA	త్వరత్వరగా
uMDAlanna	ఉండాలన్న
uMDAli	ఉండాలి
uMDAlsi	ఉండాల్సి
uMDE	ఉండే
uMDEdaTa	ఉండేదట
uMDEdi	ఉండేది
uMDEvAru	ఉండేవారు
uMDEvi	ఉండేవి
uMDaTAniki	ఉండటానికి
uMDaTaM	ఉండటం
uMDaTaMlO	ఉండటంలో
uMDaTaMtO	ఉండటంతో
uMDaTamE	ఉండటమే
uMDaTamannadi	ఉండటమన్నది
uMDadu	ఉండదు
uMDagA	ఉండగా
uMDakUDadu	ఉండకూడదు
uMDakapOvaccu	ఉండకపోవచ్చు
uMDalEranI	ఉండలేరనీ
uMDalErani	ఉండలేరని
uMDaru	ఉండరు
uMDavanI	ఉండవనీ
uMDavu	ఉండవు
uMDi	ఉండి
uMDipOyAraTa	ఉండిపోయారట
uMDipOyAru	ఉండిపోయారు
uMDoccani	ఉండొచ్చని
uMDoccu	ఉండొచ్చు
uMTADO	ఉంటాడో
uMTADu	ఉంటాడు
uMTAM	ఉంటాం
uMTAru	ఉంటారు
uMTAyO	ఉంటాయో
uMTAyani	ఉంటాయని
uMTAyanna	ఉంటాయన్న
uMTAyannadi	ఉంటాయన్నది
uMTAyi	ఉంటాయి
uMTAyigAnI	ఉంటాయిగానీ
uMTE	ఉంటే
uMTEnE	ఉంటేనే
uMTOMdi	ఉంటోంది
uMTuMDaTaM	ఉంటుండటం
uMTuMdA	ఉంటుందా
uMTuMdani	ఉంటుందని
uMTuMdi	ఉంటుంది
uMTuMdigAnI	ఉంటుందిగానీ
uMTunnAM	ఉంటున్నాం
uMTunnAyi	ఉంటున్నాయి
uMTunnaTTu	ఉంటున్నట్టు
uMcAli	ఉంచాలి
uMcakUDadu	ఉంచకూడదు
uMcukOvaccu	ఉంచుకోవచ్చు
uMcukuni	ఉంచుకుని
uMdA	ఉందా
uMdO	ఉందో
uMdani	ఉందని
uMdanna	ఉందన్న
uMdannadi	ఉందన్నది
uMdanukOvaccu	ఉందనుకోవచ్చు
uMdanukuMTU	ఉందనుకుంటూ
uMdi	ఉంది
uMdikkaDa	ఉందిక్కడ
uMgAuMgAla	ఉంగాఉంగాల
ucita	ఉచిత
ucitaMgA	ఉచితంగా
udAharaNaku	ఉదాహరణకు
udayAnnE	ఉదయాన్నే
udayaM	ఉదయం
udbhaviMciMdani	ఉద్భవించిందని
uddIpana	ఉద్దీపన
uddIpanalannI	ఉద్దీపనలన్నీ
udyOgAla	ఉద్యోగాల
udyOgAllO	ఉద్యోగాల్లో
udyOgAlu	ఉద్యోగాలు
udyOgAniki	ఉద్యోగానికి
udyOgAvakASAla	ఉద్యోగావకాశాల
udyOgAvakASAlapai	ఉద్యోగావకాశాలపై
udyOga	ఉద్యోగ
udyOgaM	ఉద్యోగం
udyOgulanu	ఉద్యోగులను
udyOgulu	ఉద్యోగులు
udyOgulugA	ఉద్యోగులుగా
udyamAlu	ఉద్యమాలు
ugAdi	ఉగాది
ugra	ఉగ్ర
ugrarUpuDaina	ఉగ్రరూపుడైన
ugratvaM	ఉగ్రత్వం
unnA	ఉన్నా
unnADu	ఉన్నాడు
unnAM	ఉన్నాం
unnAmaMTU	ఉన్నామంటూ
unnAmani	ఉన్నామని
unnAmanna	ఉన్నామన్న
unnAnani	ఉన్నానని
unnAru	ఉన్నారు
unnAyA	ఉన్నాయా
unnAyi	ఉన్నాయి
unna	ఉన్న
unnaMta	ఉన్నంత
unnaMtaTi	ఉన్నంతటి
unnaMtamAtrAna	ఉన్నంతమాత్రాన
unnaTTu	ఉన్నట్టు
unnaTTuMDi	ఉన్నట్టుండి
unnacOTa	ఉన్నచోట
unnadE	ఉన్నదే
unnadi	ఉన్నది
unnappaTikI	ఉన్నప్పటికీ
unnappuDu	ఉన్నప్పుడు
unnatOdyOgulainA	ఉన్నతోద్యోగులైనా
unnata	ఉన్నత
unnavALlU	ఉన్నవాళ్లూ
unnavAri	ఉన్నవారి
unnavAru	ఉన్నవారు
upAdhi	ఉపాధి
upAdhyAyurAli	ఉపాధ్యాయురాలి
upAlayAla	ఉపాలయాల
upaSamanaM	ఉపశమనం
upakaristAyi	ఉపకరిస్తాయి
upakramiMcArani	ఉపక్రమించారని
upanishattula	ఉపనిషత్తుల
upasaMharistAru	ఉపసంహరిస్తారు
upavishTakONAsanaM	ఉపవిష్టకోణాసనం
upayOgaM	ఉపయోగం
upayOgapaDatAyO	ఉపయోగపడతాయో
upayOgapaDatAyi	ఉపయోగపడతాయి
upayOgapaDutuMdi	ఉపయోగపడుతుంది
urakalu	ఉరకలు
utpAdakatanu	ఉత్పాదకతను
utpAdakatatO	ఉత్పాదకతతో
utpatti	ఉత్పత్తి
utsAhAnikI	ఉత్సాహానికీ
utsAhaMgA	ఉత్సాహంగా
utsavAlaku	ఉత్సవాలకు
utsavAlni	ఉత్సవాల్ని
utsavAlu	ఉత్సవాలు
utsavAnni	ఉత్సవాన్ని
utsava	ఉత్సవ
utsavaMlA	ఉత్సవంలా
utsavarlu	ఉత్సవర్లు
utsavataMtu	ఉత్సవతంతు
utsukata	ఉత్సుకత
uttEjAnniccE	ఉత్తేజాన్నిచ్చే
uttEjaM	ఉత్తేజం
uttEjaparicE	ఉత్తేజపరిచే
uttEjitaM	ఉత్తేజితం
uttamaM	ఉత్తమం
uttaraMgA	ఉత్తరంగా
uttaradvAra	ఉత్తరద్వార
uttarvulu	ఉత్తర్వులు
utticEtulatO	ఉత్తిచేతులతో
uyyAllO	ఉయ్యాల్లో
vADAli	వాడాలి
vADE	వాడే
vADaTaM	వాడటం
vALiMTikeLli	వాళింటికెళ్లి
vALlUrilO	వాళ్లూరిలో
vALla	వాళ్ల
vALlaMtA	వాళ్లంతా
vALlakE	వాళ్లకే
vALlaku	వాళ్లకు
vALlani	వాళ్లని
vALlannayya	వాళ్లన్నయ్య
vALliMTiki	వాళ్లింటికి
vALliMTlO	వాళ్లింట్లో
vALlu	వాళ్లు
vAMCa	వాంఛ
vAMCala	వాంఛల
vAMCalaku	వాంఛలకు
vAMCalakuMDE	వాంఛలకుండే
vAMCalannavi	వాంఛలన్నవి
vAMCalanu	వాంఛలను
vAMCalapai	వాంఛలపై
vAMCallO	వాంఛల్లో
vAMCalu	వాంఛలు
vAMCalutaggipOyinappuDu	వాంఛలుతగ్గిపోయినప్పుడు
vATAdArlaku	వాటాదార్లకు
vATAnu	వాటాను
vATi	వాటి
vATiki	వాటికి
vATilO	వాటిలో
vATillutuMdOnanna	వాటిల్లుతుందోనన్న
vATinI	వాటినీ
vATini	వాటిని
vATitOpATU	వాటితోపాటూ
vAdyAlni	వాద్యాల్ని
vAdyakArulu	వాద్యకారులు
vAhanAlU	వాహనాలూ
vAhanAlalO	వాహనాలలో
vAhanAlanU	వాహనాలనూ
vAhanAlanu	వాహనాలను
vAhanAllO	వాహనాల్లో
vAhanAlu	వాహనాలు
vAhana	వాహన
vAhanadArulaku	వాహనదారులకు
vAjIkaraNAllAMTivE	వాజీకరణాల్లాంటివే
vAkyUm	వాక్యూమ్
vAlEvANni	వాలేవాణ్ని
vApi	వాపి
vArU	వారూ
vAraM	వారం
vAraMlO	వారంలో
vArapu	వారపు
vArasatvamE	వారసత్వమే
vAri	వారి
vAriMciMdi	వారించింది
vArikOsaM	వారికోసం
vArikaMTE	వారికంటే
vAriki	వారికి
vArilO	వారిలో
vArilOnE	వారిలోనే
vArini	వారిని
vAritO	వారితో
vArshikOtsava	వార్షికోత్సవ
vArshika	వార్షిక
vArta	వార్త
vAru	వారు
vAskyular	వాస్క్యులర్
vAstavAlu	వాస్తవాలు
vAstavAniki	వాస్తవానికి
vAstava	వాస్తవ
vAstavamEgAnI	వాస్తవమేగానీ
vAstavika	వాస్తవిక
vAtAvaraNaM	వాతావరణం
vEDukalatO	వేడుకలతో
vEDukalu	వేడుకలు
vELaku	వేళకు
vELalanu	వేళలను
vELalu	వేళలు
vELlE	వేళ్లే
vEMgi	వేంగి
vEMgini	వేంగిని
vEMkaTAdri	వేంకటాద్రి
vEMkaTAdriki	వేంకటాద్రికి
vEMkaTESa	వేంకటేశ
vEMkaTESuDu	వేంకటేశుడు
vEMkaTESvarasvAmi	వేంకటేశ్వరస్వామి
vEMkaTESvaruDE	వేంకటేశ్వరుడే
vEMkaTESvaruNNi	వేంకటేశ్వరుణ్ణి
vEMkaTapatiki	వేంకటపతికి
vENugOpAlan	వేణుగోపాలన్
vESAru	వేశారు
vETADEMduku	వేటాడేందుకు
vEdavyAsuDu	వేదవ్యాసుడు
vEdika	వేదిక
vEdikapai	వేదికపై
vEgAnikI	వేగానికీ
vEgAnni	వేగాన్ని
vEga	వేగ
vEgaM	వేగం
vEgaMgA	వేగంగా
vEgamU	వేగమూ
vEla	వేల
vElallO	వేలల్లో
vElitO	వేలితో
vElu	వేలు
vEmaSarma	వేమశర్మ
vErE	వేరే
vErokarni	వేరొకర్ని
vEsE	వేసే
vEsEMduku	వేసేందుకు
vEsETappuDu	వేసేటప్పుడు
vEsEppuDu	వేసేప్పుడు
vEsavilO	వేసవిలో
vEsi	వేసి
vEstE	వేస్తే
vEstU	వేస్తూ
vEstunnAyi	వేస్తున్నాయి
vEsukOvAli	వేసుకోవాలి
vEtana	వేతన
vEyAli	వేయాలి
vEyaMDi	వేయండి
vEyaTaM	వేయటం
vEyaTamU	వేయటమూ
vEyanivvadu	వేయనివ్వదు
vEyarAdu	వేయరాదు
vEyi	వేయి
vEyistunnArAme	వేయిస్తున్నారామె
vEyoccu	వేయొచ్చు
vIDipOyAyi	వీడిపోయాయి
vILlE	వీళ్లే
vILlu	వీళ్లు
vITanniMTikI	వీటన్నింటికీ
vITanniMTinI	వీటన్నింటినీ
vITi	వీటి
vITiki	వీటికి
vITilO	వీటిలో
vITilOni	వీటిలోని
vITini	వీటిని
vITitO	వీటితో
vITivalla	వీటివల్ల
vIdhullO	వీధుల్లో
vIgipOvaTAniki	వీగిపోవటానికి
vIgipOvaccu	వీగిపోవచ్చు
vIlaina	వీలైన
vIlainaMta	వీలైనంత
vIllEdu	వీల్లేదు
vIllEni	వీల్లేని
vIlugA	వీలుగా
vIrAsanaM	వీరాసనం
vIrAvESaMtO	వీరావేశంతో
vIrabhadruDu	వీరభద్రుడు
vIrabhadruNNi	వీరభద్రుణ్ణి
vIri	వీరి
vIriki	వీరికి
vIrilO	వీరిలో
vIrini	వీరిని
vIru	వీరు
vIryaM	వీర్యం
vRddhApyAniki	వృద్ధాప్యానికి
vRddhApyaM	వృద్ధాప్యం
vRddhApyaMlO	వృద్ధాప్యంలో
vRddhula	వృద్ధుల
vRddhulaku	వృద్ధులకు
vRkshAniki	వృక్షానికి
vRkshAnni	వృక్షాన్ని
vRkshaM	వృక్షం
vRshaNAla	వృషణాల
vRthA	వృథా
vRttAkAraMlO	వృత్తాకారంలో
vRtti	వృత్తి
vULlannI	వూళ్లన్నీ
vULlokeLli	వూళ్లొకెళ్లి
vULlonE	వూళ్లొనే
vUbakAyAllO	వూబకాయాల్లో
vUbakAyaM	వూబకాయం
vUbakAyullO	వూబకాయుల్లో
vUgisalADutuMTuMdi	వూగిసలాడుతుంటుంది
vUhistuMTEnE	వూహిస్తుంటేనే
vUpiritittulE	వూపిరితిత్తులే
vUpiritittullO	వూపిరితిత్తుల్లో
vUpiritittulu	వూపిరితిత్తులు
vUrEgutunna	వూరేగుతున్న
vUrUrA	వూరూరా
vUraTa	వూరట
vUrapiccuka	వూరపిచ్చుక
vUravatalivaipu	వూరవతలివైపు
vUri	వూరి
vUriki	వూరికి
va	వ
vaDDI	వడ్డీ
vaMSIyulE	వంశీయులే
vaMSapAraMparyaMgA	వంశపారంపర్యంగా
vaMTi	వంటి
vaMTivI	వంటివీ
vaMTivannI	వంటివన్నీ
vaMTivi	వంటివి
vaMdakOTlanu	వందకోట్లను
vaMdala	వందల
vaMdarUpAlatO	వందరూపాలతో
vaMgAli	వంగాలి
vaMgEMtavaraku	వంగేంతవరకు
vaMgaTaM	వంగటం
vaMgi	వంగి
vaMtU	వంతూ
vaMtuna	వంతున
vaSishTha	వశిష్ఠ
vaSishThuDi	వశిష్ఠుడి
vaccADaMTE	వచ్చాడంటే
vaccADu	వచ్చాడు
vaccAkE	వచ్చాకే
vaccAru	వచ్చారు
vaccAyi	వచ్చాయి
vaccE	వచ్చే
vaccEdi	వచ్చేది
vaccEsariki	వచ్చేసరికి
vaccEsiMdi	వచ్చేసింది
vaccEvAraMdari	వచ్చేవారందరి
vacci	వచ్చి
vacciMdO	వచ్చిందో
vacciMdanI	వచ్చిందనీ
vacciMdani	వచ్చిందని
vacciMdi	వచ్చింది
vaccina	వచ్చిన
vaccinappaTi	వచ్చినప్పటి
vaccinappuDE	వచ్చినప్పుడే
vaccinappuDu	వచ్చినప్పుడు
vaccinavATini	వచ్చినవాటిని
vadalAli	వదలాలి
vadalaMDi	వదలండి
vadalaTaM	వదలటం
vaddA	వద్దా
vadda	వద్ద
vaddaku	వద్దకు
vaddanE	వద్దనే
vaddanukuMTE	వద్దనుకుంటే
vaddu	వద్దు
vadhUvarulu	వధూవరులు
vadigA	వదిగా
vadilEsi	వదిలేసి
vadilEstuMTArugAnI	వదిలేస్తుంటారుగానీ
vadilinappuDu	వదిలినప్పుడు
vadilinapuDu	వదిలినపుడు
vadulaina	వదులైన
vadulutU	వదులుతూ
vaiSAkha	వైశాఖ
vaiSAkhamAsaMlO	వైశాఖమాసంలో
vaiSyA	వైశ్యా
vaibhavAlu	వైభవాలు
vaibhavAnnI	వైభవాన్నీ
vaibhavaM	వైభవం
vaibhavaMgA	వైభవంగా
vaibrETarla	వైబ్రేటర్ల
vaidyAnikE	వైద్యానికే
vaidyAniki	వైద్యానికి
vaidya	వైద్య
vaidyaM	వైద్యం
vaidyaMlO	వైద్యంలో
vaidyamE	వైద్యమే
vaidyaparaMgA	వైద్యపరంగా
vaidyapariSOdhanA	వైద్యపరిశోధనా
vaidyaraMgaM	వైద్యరంగం
vaidyaraMgaMlO	వైద్యరంగంలో
vaidyuDu	వైద్యుడు
vaidyula	వైద్యుల
vaidyulakuMDE	వైద్యులకుండే
vaidyulanu	వైద్యులను
vaidyulatO	వైద్యులతో
vaidyulu	వైద్యులు
vaijJAnikaMgA	వైజ్ఞానికంగా
vaikalyaM	వైకల్యం
vaikhari	వైఖరి
vaikharilO	వైఖరిలో
vaikharilOnE	వైఖరిలోనే
vaikuMTha	వైకుంఠ
vaipu	వైపు
vaipula	వైపుల
vaipunaku	వైపునకు
vairudhya	వైరుధ్య
vaishNava	వైష్ణవ
vaishNavulakU	వైష్ణవులకూ
vaishNavulu	వైష్ణవులు
vaiyaktika	వైయక్తిక
vakraviSlEshaNalu	వక్రవిశ్లేషణలు
vaksha	వక్ష
vakshasthalaM	వక్షస్థలం
vakuLamAta	వకుళమాత
valasa	వలస
valayaMlO	వలయంలో
vallE	వల్లే
valla	వల్ల
vallabhuDu	వల్లభుడు
vanavihArAniki	వనవిహారానికి
vanyaprANula	వన్యప్రాణుల
varAhasvAmivArini	వరాహస్వామివారిని
varAlavarshaM	వరాలవర్షం
varD	వర్డ్
varakU	వరకూ
varaku	వరకు
vark	వర్క్
varshAkAlaMlO	వర్షాకాలంలో
vartamAnAniki	వర్తమానానికి
vartamAnaMlO	వర్తమానంలో
varusa	వరుస
varusagA	వరుసగా
vasati	వసతి
vasatigadulu	వసతిగదులు
vasatula	వసతుల
vasatulu	వసతులు
vastAru	వస్తారు
vastAyani	వస్తాయని
vastE	వస్తే
vastOMdi	వస్తోంది
vastrAnni	వస్త్రాన్ని
vastradhAraNatO	వస్త్రధారణతో
vastu	వస్తు
vastuMTAyi	వస్తుంటాయి
vastuMTE	వస్తుంటే
vastuMdEmOnanna	వస్తుందేమోనన్న
vastuMdO	వస్తుందో
vastuMdi	వస్తుంది
vastunna	వస్తున్న
vayAgrA	వయాగ్రా
vayasEmI	వయసేమీ
vayasU	వయసూ
vayassu	వయస్సు
vayasu	వయసు
vayasuku	వయసుకు
vayasulEni	వయసులేని
vayasulO	వయసులో
vayasulOnU	వయసులోనూ
vayasulOnainA	వయసులోనైనా
vayasullOnU	వయసుల్లోనూ
vayasutO	వయసుతో
veLadAM	వెళదాం
veLlAli	వెళ్లాలి
veLlAlsi	వెళ్లాల్సి
veLlAlsina	వెళ్లాల్సిన
veLlE	వెళ్లే
veLlEMduku	వెళ్లేందుకు
veLlEMta	వెళ్లేంత
veLlElA	వెళ్లేలా
veLlEvAraTa	వెళ్లేవారట
veLlaDAniki	వెళ్లడానికి
veLlaDaM	వెళ్లడం
veLlagoDutuMdani	వెళ్లగొడుతుందని
veLlakuMDA	వెళ్లకుండా
veLli	వెళ్లి
veLliMdi	వెళ్లింది
veLlipOdAM	వెళ్లిపోదాం
veLlipOtAyi	వెళ్లిపోతాయి
veLlipOyADu	వెళ్లిపోయాడు
veLlipOyE	వెళ్లిపోయే
veLloccu	వెళ్లొచ్చు
veLloddannAru	వెళ్లొద్దన్నారు
veLtAyi	వెళ్తాయి
veLtE	వెళ్తే
veLtuMTAyi	వెళ్తుంటాయి
veMTUru	వెంటూరు
veMTa	వెంట
veMTanE	వెంటనే
veMgamAMba	వెంగమాంబ
veMkaTAdri	వెంకటాద్రి
veMkaTESvara	వెంకటేశ్వర
veb	వెబ్
vecciMcAlaMTE	వెచ్చించాలంటే
vecciMcE	వెచ్చించే
velasi	వెలసి
velasiMdannadi	వెలసిందన్నది
velasiMdi	వెలసింది
velasina	వెలసిన
veliSADani	వెలిశాడని
veligistAru	వెలిగిస్తారు
velisina	వెలిసిన
vella	వెల్ల
vellaDaiMdi	వెల్లడైంది
vellaDiMciMdi	వెల్లడించింది
vellakilA	వెల్లకిలా
velugulOki	వెలుగులోకి
velugulu	వెలుగులు
velustAyi	వెలుస్తాయి
veluturu	వెలుతురు
veluvaDiMdi	వెలువడింది
venakabaDE	వెనకబడే
venakki	వెనక్కి
venakkiveLliMdi	వెనక్కివెళ్లింది
venuka	వెనుక
venukabaDutunnArani	వెనుకబడుతున్నారని
vesulubATu	వెసులుబాటు
vetikinA	వెతికినా
veyyELlapATu	వెయ్యేళ్లపాటు
veyyaTaM	వెయ్యటం
viDici	విడిచి
viDigA	విడిగా
viDipOtAyi	విడిపోతాయి
viDivaDaTaM	విడివడటం
viDudala	విడుదల
viSAla	విశాల
viSEshAlanu	విశేషాలను
viSEshAlu	విశేషాలు
viSEsha	విశేష
viSEshaM	విశేషం
viSEshaMgA	విశేషంగా
viSlEshaNE	విశ్లేషణే
viSlEshaNalatO	విశ్లేషణలతో
viSlEshistAru	విశ్లేషిస్తారు
viSrAMti	విశ్రాంతి
viSvAsAnni	విశ్వాసాన్ని
viSvAsaM	విశ్వాసం
viSvasistAru	విశ్వసిస్తారు
viSvavidyAlaya	విశ్వవిద్యాలయ
viTamin	విటమిన్
vibhAgaM	విభాగం
vibhAgamainA	విభాగమైనా
vibhAjaka	విభాజక
vibhajiMcukoni	విభజించుకొని
vicAraNa	విచారణ
viccEsE	విచ్చేసే
vidhAlugA	విధాలుగా
vidhAnAlanu	విధానాలను
vidhAnAlu	విధానాలు
vidhAnaMgA	విధానంగా
vidhAnaMlO	విధానంలో
vidhaMgA	విధంగా
vidhi	విధి
vidhistAru	విధిస్తారు
vidhistU	విధిస్తూ
vidhulu	విధులు
vidhvaMsaM	విధ్వంసం
vidyArthi	విద్యార్థి
vidyArthinI	విద్యార్థినీ
vidyArthulU	విద్యార్థులూ
vidyArthula	విద్యార్థుల
vidyArthulaku	విద్యార్థులకు
vidyArthulanu	విద్యార్థులను
vidyAvaMtulainA	విద్యావంతులైనా
vidya	విద్య
vighAtaMgA	విఘాతంగా
vigrahAnni	విగ్రహాన్ని
vigrahaM	విగ్రహం
vigrahaMpainunna	విగ్రహంపైనున్న
vigrahamU	విగ్రహమూ
vijEta	విజేత
vijJAnAnni	విజ్ఞానాన్ని
vijJAnaM	విజ్ఞానం
vijJAnaMgA	విజ్ఞానంగా
vijJAnadAyakaM	విజ్ఞానదాయకం
vijayAla	విజయాల
vijayAlu	విజయాలు
vijaya	విజయ
vijayaM	విజయం
vijayanagara	విజయనగర
vijayanagaraM	విజయనగరం
vijayavADa	విజయవాడ
vikTOriyan	విక్టోరియన్
vikalAMgulaku	వికలాంగులకు
vikalAMgulu	వికలాంగులు
vikhyAta	విఖ్యాత
vikrayistAru	విక్రయిస్తారు
vikrayistOMdi	విక్రయిస్తోంది
vikrayistunnAru	విక్రయిస్తున్నారు
vilInAnaMtaraM	విలీనానంతరం
vilInAniki	విలీనానికి
vilIna	విలీన
vilInaM	విలీనం
vilInaMtO	విలీనంతో
vilasillutOMdi	విలసిల్లుతోంది
viluva	విలువ
viluvaina	విలువైన
vimAnASrayAniki	విమానాశ్రయానికి
vimAnASrayaM	విమానాశ్రయం
vimAnASrayaMlO	విమానాశ్రయంలో
vimAnASrayamE	విమానాశ్రయమే
vimarSakulu	విమర్శకులు
vimarSiMcaTaM	విమర్శించటం
vimukti	విముక్తి
vin	విన్
vinAyakuNNi	వినాయకుణ్ణి
vinipistOMdi	వినిపిస్తోంది
viniyOgadArlatO	వినియోగదార్లతో
viniyOgadArlu	వినియోగదార్లు
viniyOgiMcukuMTU	వినియోగించుకుంటూ
vinna	విన్న
viparIta	విపరీత
vipariNAmaM	విపరిణామం
viplavaM	విప్లవం
virALAliccAru	విరాళాలిచ్చారు
virALAlu	విరాళాలు
virAg	విరాగ్
virAmaM	విరామం
virUpAkshAnaMda	విరూపాక్షానంద
virUpAkshuDu	విరూపాక్షుడు
viramaNaku	విరమణకు
virigi	విరిగి
viriginapuDE	విరిగినపుడే
viruddha	విరుద్ధ
viruguDu	విరుగుడు
visarjana	విసర్జన
visarjanaku	విసర్జనకు
visarjitamavutAyi	విసర్జితమవుతాయి
vishAda	విషాద
vishNu	విష్ణు
vishatulyAlanu	విషతుల్యాలను
vishatulyAlu	విషతుల్యాలు
vishayAlakU	విషయాలకూ
vishayAlanu	విషయాలను
vishayAllO	విషయాల్లో
vishayAlu	విషయాలు
vishayAniki	విషయానికి
vishayAnikostE	విషయానికొస్తే
vishayAnni	విషయాన్ని
vishayaM	విషయం
vishayaMlO	విషయంలో
vishayaMlOnU	విషయంలోనూ
visigiMcaku	విసిగించకు
vismariMcaTaM	విస్మరించటం
vismariMcakUDadu	విస్మరించకూడదు
vistIrNaMlO	విస్తీర్ణంలో
vistRtamaina	విస్తృతమైన
vistariMcAyi	విస్తరించాయి
vistariMcipOtU	విస్తరించిపోతూ
vistaristU	విస్తరిస్తూ
visugu	విసుగు
vivAha	వివాహ
vivarAlaku	వివరాలకు
vivarAlanu	వివరాలను
vivarAlivi	వివరాలివి
vivarAlu	వివరాలు
vivariMcA	వివరించా
vivariMcaTaM	వివరించటం
vivariMciMdi	వివరించింది
vivaristE	వివరిస్తే
vividha	వివిధ
viyOgAnni	వియోగాన్ని
vrataM	వ్రతం
vuMTuMdi	వుంటుంది
vyAdhE	వ్యాధే
vyAdhula	వ్యాధుల
vyAdhulaku	వ్యాధులకు
vyAdhulu	వ్యాధులు
vyAkOciMcaTAniki	వ్యాకోచించటానికి
vyAkOciMci	వ్యాకోచించి
vyAkulata	వ్యాకులత
vyApArAlu	వ్యాపారాలు
vyApAraM	వ్యాపారం
vyApArulu	వ్యాపారులు
vyApta	వ్యాప్త
vyAyAmAla	వ్యాయామాల
vyAyAmAlakU	వ్యాయామాలకూ
vyAyAmAllO	వ్యాయామాల్లో
vyAyAmAllOnU	వ్యాయామాల్లోనూ
vyAyAmAlu	వ్యాయామాలు
vyAyAmAnikI	వ్యాయామానికీ
vyAyAmAnni	వ్యాయామాన్ని
vyAyAma	వ్యాయామ
vyAyAmaM	వ్యాయామం
vyAyAmaMgAnE	వ్యాయామంగానే
vyAyAmaMlO	వ్యాయామంలో
vyAyAmaMtO	వ్యాయామంతో
vyAyAmamE	వ్యాయామమే
vyUha	వ్యూహ
vyaktIkariMcE	వ్యక్తీకరించే
vyakta	వ్యక్త
vyaktaM	వ్యక్తం
vyakti	వ్యక్తి
vyaktigata	వ్యక్తిగత
vyaktini	వ్యక్తిని
vyaktula	వ్యక్తుల
vyarthAlu	వ్యర్థాలు
vyarthamaina	వ్యర్థమైన
vyavadhilO	వ్యవధిలో
vyavahAraM	వ్యవహారం
vyavahAraMgA	వ్యవహారంగా
vyavahAraMgAnE	వ్యవహారంగానే
vyavahAraMlO	వ్యవహారంలో
vyavahAramanna	వ్యవహారమన్న
vyavahariMcAru	వ్యవహరించారు
vyavahariMcE	వ్యవహరించే
vyavaharistunnAru	వ్యవహరిస్తున్నారు
vyavasthIkRtaM	వ్యవస్థీకృతం
vyavasthalannI	వ్యవస్థలన్నీ
yAdAdri	యాదాద్రి
yAdRcCikaMgA	యాదృచ్ఛికంగా
yAda	యాద
yAdagiriguTTa	యాదగిరిగుట్ట
yAdagiriguTTaku	యాదగిరిగుట్టకు
yAdagiriguTTalOni	యాదగిరిగుట్టలోని
yAdamaharshi	యాదమహర్షి
yAdamaharshiki	యాదమహర్షికి
yAgAnni	యాగాన్ని
yArlagaDDa	యార్లగడ్డ
yAtrikula	యాత్రికుల
yAvat	యావత్
yOgA	యోగా
yOgAbhyAsAniki	యోగాభ్యాసానికి
yOgAbhyAsa	యోగాభ్యాస
yOgAbhyAsaM	యోగాభ్యాసం
yOgAbhyAsaMtOnE	యోగాభ్యాసంతోనే
yOgAkU	యోగాకూ
yOgAku	యోగాకు
yOgAlO	యోగాలో
yOgAnu	యోగాను
yOgAsanAla	యోగాసనాల
yOgAsanAlanu	యోగాసనాలను
yOgAsanAlu	యోగాసనాలు
yOgAtO	యోగాతో
yOgAvalla	యోగావల్ల
yOga	యోగ
yOgaM	యోగం
yOgamaMTE	యోగమంటే
yOgamanna	యోగమన్న
yOgasAdhana	యోగసాధన
yOgasAdhananu	యోగసాధనను
yajJAniki	యజ్ఞానికి
yajJAnni	యజ్ఞాన్ని
yajJaM	యజ్ఞం
yajamAni	యజమాని
yatIMdra	యతీంద్ర
yathAsthitiki	యథాస్థితికి
yavvana	యవ్వన
yugAla	యుగాల
yuj	యుజ్
yuktavayasu	యుక్తవయసు
yuktavayasuku	యుక్తవయసుకు
yuktavayasulO	యుక్తవయసులో
